Are more people today related to Genghis Khan than Julius Caesar?	yes </s>
Could the members of The Police perform lawful arrests?	no </s>
Would a Monoamine Oxidase candy bar cheer up a depressed friend?	no </s>
Would a dog respond to bell before Grey seal?	yes </s>
Is a pound sterling valuable?	no </s>
Is shrimp scampi definitely free of plastic?	no </s>
Do the anchors on Rede Globo speak Chinese?	no </s>
Is a Boeing 737 cost covered by Wonder Woman (2017 film) box office receipts?	yes </s>
Can you buy Casio products at Petco?	no </s>
Did the Space Race use relay batons?	no </s>
Are Christmas trees dissimilar to deciduous trees?	yes </s>
Does Biochemistry study gluons?	no </s>
Did land owners elect their rulers in the Kingdom of Hungary?	no </s>
Would Nancy Pelosi publicly denounce abortion?	no </s>
Does Dragon Ball shows and movies fall short of Friday 13th number of projects?	yes </s>
Would a student of the class of 2017 have amnesia about 9/11?	yes </s>
Would a psychic who admits to hot reading be trustworthy?	no </s>
Is average number of peas in a pod enough commas for a billion?	yes </s>
Does actress Leila George lack the height to be a model?	no </s>
Is Dustin Hoffman one of the B'nei Yisrael?	yes </s>
If you were on a diet, would you have to skip lunch at McDonald's?	no </s>
Could the Powerpuff Girls hypothetically attend the Camden Military Academy?	no </s>
Would an uninsured person be more likely than an insured person to decline a CT scan?	yes </s>
Was the Donatello crucifix identified in 2020 life size?	no </s>
Is Disneyland Paris the largest Disney resort?	no </s>
Could someone with fine motor control issues benefit from an altered keyboard layout?	yes </s>
Would Adam Sandler get a reference to Cole Spouse and a scuba man doll?	yes </s>
Is there a warthog on Broadway?	yes </s>
Does Disney have an ice princess?	yes </s>
Would a geographer use biochemistry in their work?	no </s>
Could George Washington's own speeches have been recorded live to a compact disc?	no </s>
Would food made with black salt smell of sulfur?	yes </s>
Would a broadcast from Spirit make the news in 2020?	yes </s>
Could Robert Wadlow hypothetically see Frankenstein's monster's bald spot from above?	yes </s>
Is the tibia necessary to win the Stanley Cup?	yes </s>
Would an ethics professor teach a class on Cezanne?	no </s>
If you add water to rice pudding is it horchata?	no </s>
If your skin was turning the color of a zombie, could it be because of nickel?	yes </s>
Would a Dolce & Gabbana suit wearer be shunned by their Amish cousins?	yes </s>
Is the Illuminati card game still popular?	no </s>
Can a strawberry get worms similar to dogs?	yes </s>
Is Menthol associated with Thanksgiving?	no </s>
Would someone in Mumbai refer to Solanum melongena as an eggplant?	no </s>
Is it okay to lie after taking an oath in a court of law?	no </s>
Is art prioritized in the US education system?	no </s>
While on a liquid diet, are there some types of soup you cannot eat?	yes </s>
Would it be impossible to use an Iwato scale for a twelve-tone technique composition?	yes </s>
Would the Titanic be well preserved at the bottom of the Gulf of Finland?	yes </s>
Could a dandelion suffer from hepatitis?	no </s>
Would a week be enough time to watch every episode of Ugly Betty?	yes </s>
Was the Louisiana Purchase made with bitcoin?	no </s>
Did Japanese serfdom have higher status than English counterpart?	yes </s>
Is the best tasting part of the papaya in the center?	no </s>
Could Lil Wayne's children ride in a Chevrolet Corvette ZR1 together?	no </s>
Is double duty an incorrect phrase for host of Dancing With The Stars?	no </s>
Could an ocelot subsist on a single bee hummingbird per day?	no </s>
Does Ukrainian Greek Catholic Church recognize Alexander Nevsky as a saint?	no </s>
Was the original James Bond actor born near the Washington Monument?	no </s>
Did J. P. Morgan have healthy lungs?	no </s>
Would Firefighters be included in a September 11th memorial?	yes </s>
Does Andrew Johnson's presidential number exceed Elagabalus's Emperor number?	no </s>
Are any animals in Chinese calendar Chordata?	yes </s>
Would a hypothetical Yeti be towered over by Andre the Giant?	yes </s>
Was The Little Prince's titular character allergic to flowers?	no </s>
Did Millard Fillmore help to establish the University of Pittsburgh?	no </s>
Does Northern fur seal make good pet for six year old?	no </s>
Would a pear sink in water?	no </s>
WIll Noah's Ark hypothetically sail through flooded Lincoln Tunnel?	no </s>
Can you write a whole Haiku in a single tweet?	yes </s>
Would you take a photo of a Saltwater crocodile in Memphis?	no </s>
Could Scooby Doo fit in a kangaroo pouch?	no </s>
Do manta rays live in water above the safe temperature for cold food storage?	yes </s>
Is the kayak a traditional boat in New Zealand?	no </s>
Has the Subway restaurant franchise had any connections with child abusers?	yes </s>
Would the high school class of 2010 have lived through the Presidency of Richard Nixon?	no </s>
Would a Deacon be likely to be a fan of the podcast 'God Awful Movies'?	no </s>
Could a giant squid fit aboard the deck of the titanic?	yes </s>
Is Antarctica a good location for Groundhog Day?	no </s>
Can the Powerpuff Girls form a complete tag team wrestling match?	no </s>
Will someone die without white blood cells?	yes </s>
Does rock star Keith Richards play a captain of a boat in a movie?	yes </s>
Would an eleventh-grader be eligible for Medicare?	no </s>
Is there a full Neptunian orbit between the first two burials of women in the Panth√©on?	no </s>
Will Oasis cruise boat traverse the Lincoln Tunnel?	no </s>
Could Oscar Wilde have operated a motor vehicle?	yes </s>
Will Tokyo Tower be repainted only once during President Trump's first term?	yes </s>
Has a neanderthal ever served on the Supreme Court of the United States?	no </s>
Can Clouded leopards chase down many Pronghorn antelopes?	no </s>
Does the anatomy of a camel lend itself to jokes on Wednesdays?	yes </s>
Can voice actors for Goofy and Bugs Bunny each get one stripe from American flag?	yes </s>
Did Clark Gable appear in any movies scored by John Williams?	no </s>
Is Linus Torvalds' wife unable to physically defend herself?	no </s>
Did Eric Clapton have similar taste in women to one of the Beatles?	yes </s>
Did Eddie Murphy's father see his first stand up show?	no </s>
Could a silverfish reach the top of the Empire State Building?	no </s>
Are there winged statuettes in the home of the creator of Law & Order?	yes </s>
Was Donald Trump the target of Islamophobia?	no </s>
Would baker's dozen of side by side Mac Trucks jam up Golden Gate Bridge?	yes </s>
Could someone mistake the smell of your brussels sprouts for a fart?	yes </s>
Do guitarist's have fingers that can handle pain better than average?	yes </s>
Were there under 150,000 American troops in Vietnam in 1965?	yes </s>
Did Native American tribes teach Spaniards how to cultivate maize?	yes </s>
Has Oscar Wilde's most famous character ever been in an Eva Green project?	yes </s>
Do frogs feel disgust?	yes </s>
Did either Kublai Khan or his grandfather practice monogamy?	no </s>
Does a person need to be a parent to become a grandparent?	yes </s>
Did Van Gogh suffer from a mental disorder?	yes </s>
Is the span in C-SPAN named after Alan Greenspan?	no </s>
Would Eminem perform well at the International Mathematical Olympiad?	no </s>
Is Guitar Hero Beatles inappropriate for a US third grader?	no </s>
In American society, will a bachelor's degree often include a leap year?	yes </s>
At a presentation about post traumatic stress disorder, would Ariana Grande be a topic of relevance?	yes </s>
Were plants crucial for The King of Rock'n Roll's snack with bananas?	yes </s>
Could you read The Atlantic magazine during the Games of the XXII Olympiad?	yes </s>
Can you find Bob Marley's face in most smoke shops?	yes </s>
Could Elizabeth I of England have seen the play Dido, Queen of Carthage ?	yes </s>
Is Britney Spears' breakdown attributed to bipolar disorder?	yes </s>
Is week old chlorine water safe to drink?	yes </s>
Is the foot part of the metric system?	no </s>
Would it be typical for a Rede Globo anchor to say Konnichiwa to the viewers?	no </s>
Does Hades appear in a Disney Channel musical movie?	yes </s>
Were weather phenomena avoided when naming minor league baseball teams?	no </s>
Could a Hwasong-15 missile hypothetically reach Voyager 2?	no </s>
Could someone theoretically use an armadillo as a shield?	yes </s>
Does Linus Torvalds make money off of DirectX?	no </s>
Did a Mediterranean Sea creature kill Steve Irwin?	yes </s>
Do you need to worry about Zika virus in Antarctica? 	no </s>
Did the writer of Christmas carol fast during Ramadan? 	no </s>
Are most books written as a Haiku?	no </s>
Does the country that received the most gold medals during the 1976 Olympics still exist?	no </s>
Will Chuck Norris be a nonagenarian by time next leap year after 2020 happens?	no </s>
Does Bombyx mori have a monopoly over silk production?	no </s>
Has cannabis been a big influence in rap music genre?	yes </s>
Do Jews believe in any New Testament angels?	yes </s>
Do Christians anticipate an existence in Sheol after death?	no </s>
Would an anxious person benefit from receiving courage from the Wizard of Oz?	no </s>
Is polyamory allowed in the Catholic Church?	no </s>
Does a Generation Y member satisfy NYPD police officer age requirement?	yes </s>
Could the main character of "Alice's Adventures in Wonderland" join a Masonic Lodge?	no </s>
Did King James I despise fairy beings?	yes </s>
Did Evander Holyfield compete in an Olympics hosted in the western hemisphere?	yes </s>
Did Harry Houdini's wife make psychics look foolish?	yes </s>
Does handedness determine how you use American Sign Language?	yes </s>
Do onions have a form that resembles the inside of a tree?	yes </s>
Are moose used for work near the kingdom of Arendelle?	yes </s>
Is eleventh grade required to get a driver's licence?	no </s>
Do some home remedies result in your skin color turning blue?	yes </s>
Was ethanol beneficial to Jack Kerouac's health?	no </s>
Did Doctor Strange creators also make Batman?	no </s>
Was Charlemagne's father instrumental in outcome of the Battle of Tours?	no </s>
Would Janet Jackson avoid a dish with ham?	yes </s>
Can giant pandas sell out a Metallica show?	no </s>
Would multiple average rulers be necessary to measure the length of a giant armadillo?	yes </s>
Can you only see hippopotamus in Africa?	no </s>
Was Kane (wrestler) banned from WCW  headquarters city?	no </s>
Was Rumi's work serialized in a magazine?	no </s>
Is Olympia, Washington part of "Ish river country"?	yes </s>
Would someone with back pain enjoy picking strawberries?	no </s>
Was the Euro used in Prussia?	no </s>
Did Eiffel Tower contribute to a war victory?	yes </s>
Has the Indian Ocean garbage patch not completed two full rotations of debris since its discovery?	yes </s>
Do some religions look forward to armageddon?	yes </s>
Could a llama birth twice during War in Vietnam (1945-46)?	no </s>
Is Rick and Morty considered an anime?	no </s>
Does The Hague border multiple bodies of water?	no </s>
Could a chipmunk fit 100 chocolate chips in his mouth?	no </s>
Would a pescatarian be unable to eat anchovy pizza?	no </s>
Would Sophist's have hypothetically made good lawyers?	yes </s>
Can fish get Tonsillitis?	no </s>
Will Queen Elizabeth be buried in the Pantheon?	no </s>
Does coding rely on Boolean algebra characters?	yes </s>
Was Gandalf present at the death of Eomer?	no </s>
Are those incapable of reproduction incapable of parenthood?	no </s>
Is Mixed martial arts totally original from Roman Colosseum games?	no </s>
Can Herpes simplex virus spread on Venus?	no </s>
Is Bern located east of Paris?	yes </s>
Would keelhauling be a fair punishment under the Eighth Amendment?	no </s>
Would Franz Ferdinand have survived with armadillo armor?	no </s>
Can you find a railroad engineer on TNT?	yes </s>
Could Amazon afford The Mona Lisa?	yes </s>
Was Martin Luther same sect as Martin Luther King Jr.?	no </s>
Did Sartre write a play about Hell?	yes </s>
Can rowing competitions take place indoors?	no </s>
Were there fifty English kings throughout the Middle Ages?	no </s>
Is Thanksgiving sometimes considered a day of mourning?	yes </s>
Does Jack Sparrow know any sea shantys?	yes </s>
If someone is a vegan, would they eat honey?	no </s>
Can Lamborghini's fastest model win a race against a Porsche 911?	yes </s>
Was the Second Amendment to the United States Constitution written without consideration for black Americans?	yes </s>
Could a Gladiator's weapon crush a diamond?	no </s>
Would Republic of Korea Navy dominate Eritrea navy?	yes </s>
Could someone have arrived at Wrestlemania X in a Toyota Prius?	no </s>
Could the first European visitor to Guam been friends with Queen Victoria?	no </s>
Would the average American family find Adam Sandler's home to be too small?	no </s>
Does Santa Claus work during summer?	no </s>
Is the Hobbit more profitable for proofreader than Constitution of the United States?	yes </s>
Is Krishna similar to Holy Spirit?	yes </s>
Do human sacrums have more fused vertebrae than an Alaskan Malamute?	yes </s>
Was Snoop Dogg's debut studio album released on the weekend?	no </s>
Are Sable's a good choice of Mustelidae to weigh down a scale?	no </s>
Was Richard III ruler of Adelaide?	no </s>
Do Sweet Potatoes prevent other plants from growing in their place?	yes </s>
Should spaghetti be slick when cooked?	no </s>
While viewing "Scary Movie" is the viewer likely to experience an increase in adrenaline?	no </s>
Is All Purpose Flour safe for someone who has celiac disease?	no </s>
Is the Very Large Telescope the most productive telescope in the world?	no </s>
Is it safe to wear sandals in snow?	no </s>
Is the cuisine of Hawaii suitable for a vegan?	no </s>
Would a customer be happy if their grocery store meat tasted like game?	no </s>
Is the Royal Air Force ensign on the moon?	no </s>
Are tampons a good 24 hour solution for mentruation?	no </s>
Can you cure hepatitis with a tonsillectomy?	no </s>
Can cancer cause excess adrenaline production?	yes </s>
Would a Frigatebird in Ontario be a strange sight?	yes </s>
Would a silicon shortage be bad for Intel's sales?	yes </s>
Has Ivan the Terrible flown to Europe?	no </s>
Could Oprah Winfrey buy dozens of her staff Bugatti luxury cars?	yes </s>
Did the Wehrmacht affect the outcome of the War to End All Wars?	no </s>
Are Leopard cats in less dire straits than Bornean Orangutan?	yes </s>
Did Snoop Dogg refuse to make music with rival gang members?	no </s>
Does the density of helium cause voices to sound deeper?	no </s>
Is Romeo and Juliet an unusual title to teach high schoolers?	no </s>
Are there multiple American government holidays during winter?	yes </s>
Is Islamophobia against Cyprus majority religion misdirected?	yes </s>
Have jokes killed more people than rats in history?	no </s>
Will parma ham be ready for New Year's if the pig is slaughtered in December?	no </s>
Does Amtrak operate four wheel vehicles?	yes </s>
Does chlorine inhibit photosynthesis?	yes </s>
Do people who smoke Djarum's like cloves?	yes </s>
Is an astronomer interested in drosophila?	no </s>
Is Atlantic cod found in a vegemite sandwich?	no </s>
Did Bruiser Brody wrestle on WWE Raw?	no </s>
Can the largest crustacean stretch out completely on a king-sized mattress?	no </s>
Do Windows or Android smartphones run newer versions of Linux?	no </s>
Does Neville Longbottom have more courage as a child than as an adult?	no </s>
Would Atlantic Salmon be within David Duchovny's dietary guidelines?	yes </s>
Do people remember Lucille Ball's winemaking as successful?	no </s>
Can a Sphynx cat be used for wool?	no </s>
Are classic nintendo games for emulator legal?	no </s>
Can you use the T-Mobile tuesdays app if you aren't a T-Mobile customer?	no </s>
Could Aretha Franklin vote for a president when her second child was born?	no </s>
Is Eighth Amendment to the United States Constitution popular in court?	no </s>
Did the Social Democratic Party of Germany help Frederick II become King of Prussia?	no </s>
Would a Catholic priest commend someone's pride?	no </s>
Did Bill Gates help to develop the PlayStation 4?	no </s>
Would a teacher still have their job if they called a black student an ape?	no </s>
Did compact discs make computer gaming more popular?	yes </s>
Do storks need golden toads to survive?	no </s>
Are any letters directly before and after H missing from Roman numerals?	yes </s>
Did the Nazis use the Hammer and sickle flag?	no </s>
Are there enough Jonny Cash records in the world to give one to each French citizen?	yes </s>
Can monkeys use QWERTY keyboards?	yes </s>
Should children be kept from "special brownies"?	yes </s>
Would Taylor Swift refer to Snoopy as oppa?	yes </s>
Can horseradish be eaten in a religious context?	yes </s>
Do hamsters provide food for any animals?	yes </s>
Will Chick-fil-A hypothetically refuse to sponsor a Pride parade?	yes </s>
Are the headquarters of All Nippon Airways near a beach?	no </s>
Does Evander Holyfield eat pork products?	yes </s>
Could John Key issue an executive order in the USA?	no </s>
Can a Goblin shark hypothetically ride a bike if it had limbs?	no </s>
Does a Trek 9000 require an anchor in order to park?	no </s>
Does Steven Spielberg's 1998 film take place in a period after War Horse setting?	yes </s>
Is November a bad time for a photographer to take pictures of a plum tree in bloom?	yes </s>
Do more Cauliflower grow in Arizona than California?	no </s>
Would Jason Voorhees hypothetically fail at being a martyr?	yes </s>
Could Palm Beach be held in the palm of your hand?	no </s>
Did Alfred Nobel write a banned book?	yes </s>
Can a quarter fit inside of a human kidney?	yes </s>
Did Boris Yeltsin watch the 2008 Summer Olympics?	no </s>
Does frost mean that it will be a snowy day?	no </s>
Are there multiple Disney Zorro?	yes </s>
Does selling a 2020 Chevrolet Corvette almost pay for a year at Columbia University?	yes </s>
Does the book Revolutionary Road give a glimpse at life in a suburb?	yes </s>
Is the Liberty Bell still in its original location?	no </s>
Does Buddy The Elf know anyone who works in publishing?	yes </s>
Is unanimously elected president's birthday a break for mail carriers?	yes </s>
Does a sea otter eat spiders?	no </s>
Could a Bengal cat hypothetically best Javier Sotomayor's record?	yes </s>
Are Chipotle Cinnamon Pork Chops appropriate for a Seder?	no </s>
Would the chef at Carmine's restaurant panic if there was no basil?	yes </s>
Is most store bought rice pudding made with brown rice?	no </s>
Did Easy Rider make a profit at the theater when it was released?	yes </s>
Do mail carriers need multiple uniforms?	yes </s>
Is Steve Martin someone who would refuse a dish of shrimp pasta?	yes </s>
As of 2020 have more women succeeded John Key than preceded him?	no </s>
Would Methuselah hypothetically hold a record in the Common Era?	yes </s>
Would you be likely to see storks at a baby shower?	yes </s>
Can Viper Room concert hypothetically be held at National Diet building?	yes </s>
Can you get a fever from consuming meat?	yes </s>
Did Ivan the Terrible use the Byzantine calendar?	yes </s>
Would a Rabbi celebrate Christmas?	no </s>
Is clementine pith highly sought after?	no </s>
Did the Nepalese Civil War take place near India?	yes </s>
Can paratroopers be used in a vacuum?	no </s>
Could the moon fit inside the Black Sea?	no </s>
Could R. Kelly write a college thesis?	no </s>
Can a chess board be converted to a Shogi board?	no </s>
Has Cesar Millan ever tamed a short-eared dog?	no </s>
Did the Eastern Orthodox Church and the Byzantine Empire ever use the same calendar?	yes </s>
Were number of states in Ancient Greece underwhelming compared to US states in 1900?	no </s>
Is the rise of agriculture attributed to rivers?	yes </s>
Are goldfish more difficult to care for than isopods?	yes </s>
Does Mario use mushrooms to run faster?	no </s>
Can eating your weight in celery prevent diabetes?	no </s>
Do restaurants associate meatballs with the wrong country of origin?	yes </s>
Would it be wise to bring a robusto into Central Park Zoo?	no </s>
Were the Great Pyramids built by a theocratic government?	yes </s>
Are sesame seeds glued onto hamburger buns?	no </s>
Was Snoop Dogg an adult when Tickle Me Elmo was popular?	yes </s>
Did James Watson's partner in studying the double helix outlive him? 	no </s>
Can atheism surpass Christianity in American black communities by 2021?	no </s>
Did the band Led Zeppelin own a prime number of gilded gramophones?	yes </s>
Are Doctors of Homeopathy more likely than Doctors of Internal Medicine to recommend Quartz as a treatment?	yes </s>
Would it be difficult to host Stanley Cup Finals at Rock in Rio?	yes </s>
Would the trees in Auburn, New York be changing colors in September?	yes </s>
Could an elephant easily defeat a male macaque?	yes </s>
Did Pedubastis I know Japanese people?	no </s>
Would a cattle farmer be useful to a drum maker?	yes </s>
Can children be hurt by jalapeno peppers?	yes </s>
Can Vice President of the United States kill with impunity?	yes </s>
Can Amtrak's Acela Express break the sound barrier?	no </s>
Are all characters in Legend of Robin Hood fictional?	no </s>
Are raw carrots better for maximizing vitamin A intake?	no </s>
Is radioactive waste a plot device for many shows?	yes </s>
Could a firewall be destroyed by a hammer?	no </s>
Can the President of Mexico vote in New Mexico primaries?	no </s>
Would the operating system of a Samsung Galaxy 1 sound edible?	yes </s>
Does Metallica use Soulseek?	no </s>
Are monks forbidden from engaging in warfare?	no </s>
Can a minotaur hypothetically injure a tibia playing football?	yes </s>
Did Columbus obtain his funding from the rulers of the Portugese Empire?	no </s>
Do shrimp taste best when cooked for a long time?	no </s>
Would a birdwatcher pursue their hobby at a Philadelphia Eagles game?	no </s>
Is Cantonese spoken in Japan?	no </s>
Do ants outperform apes on language ability?	no </s>
Would Christopher Hitchens be very unlikely to engage in tonsure?	yes </s>
Is menthol associated with Christmas?	yes </s>
Does Snoop Dogg advocate a straight edge lifestyle?	no </s>
Is it expected that Charla Nash would be anxious near a gorilla?	yes </s>
Should oysters be avoided by people with ADHD?	no </s>
Does Magnus Carlsen enjoy KFC?	no </s>
Would a packed Wembley stadium be likely to have a descendant of the Mongols inside?	yes </s>
Is Oculudentavis more dangerous than Allosaurus?	no </s>
Would James Cotton's instrument be too strident for a smooth jazz band?	yes </s>
Are there tearjerkers about United Airlines flights?	yes </s>
Would a rabbi worship martyrs Ranavalona I killed?	no </s>
Does Mercury help detect coronavirus?	yes </s>
Was The Jackson 5 bigger family band than The Isley Brothers?	yes </s>
Does a Starbucks passion tea have ginger in it?	no </s>
Do Shivambu practitioners believe ammonia is unhealthy?	no </s>
Can eating grapefruit kill besides allergies or choking?	yes </s>
Should someone prone to jealousy be in a polyamorous relationship?	no </s>
Would early Eastern Canadian Natives language have use of the letter B?	no </s>
During the pandemic, is door to door advertising considered inconsiderate?	yes </s>
Is Mickey Mouse hypothetically unlikely to make a purchase at Zazzle?	yes </s>
Is Maruti Suzuki Baleno an efficient car for Linus Torvald's family?	yes </s>
Is Benjamin Franklin a prime candidate to have his statues removed by Black Lives Matter movement?	yes </s>
Is ID required to get all medications from all pharmacies?	no </s>
Is Fiat Chrysler gaining a new overall corporate identity?	yes </s>
Did Disney get most of Rudyard Kipling's The Jungle Book profits?	yes </s>
Does an organ donor need to be dead to donate a kidney?	no </s>
Would Kelly Clarkson's voice shake glass?	yes </s>
Is a railroad engineer needed during NASCAR events?	no </s>
Can crane slamdunk?	no </s>
Did the Qwerty keyboard layout predate computers?	yes </s>
Would Alexander Hamilton have known about koalas?	no </s>
Will the torso be safe from blows to the largest and smallest bones in body?	yes </s>
Does the Dalai Lama believe in the divine barzakh?	no </s>
Is Pig Latin related to real Latin?	no </s>
Would Woodrow Wilson support Plessy v. Ferguson decision?	yes </s>
Would a Bulgarian priest eat a four-course meal on Christmas Eve?	no </s>
Is Route 66 generally unknown to Americans?	no </s>
Did the Berlin Wall prevent any athletes from competing in the 1936 Summer Olympics?	no </s>
Are the Vietnamese people a great untapped resource for NBA players?	no </s>
Will every resident of Los Angeles County, California go to Jehovah Witnesses's heaven?	no </s>
Do Australians ride Kangaroos to work?	no </s>
Did origin dynasty of Go precede Jia Sidao?	yes </s>
Are there multiple Star Wars TV shows produced by Disney?	yes </s>
Would Emma Roberts's Nancy Drew be considered a private investigator?	no </s>
Was the AK-47 used in the Seven Years' War?	no </s>
Did Helen Keller ever read a novel by J. K. Rowling?	no </s>
Would Garfield like canid food?	no </s>
Did Hamlet's author use email?	no </s>
Can Larry King's ex-wives form a water polo team?	yes </s>
Are a dozen pickles good for easing hypertension?	no </s>
Was Florence Nightingale's death more painful than Saint Peter's?	no </s>
Would Iceland lose to Amazon in a bidding war?	yes </s>
Could boolean algebra be described as binary?	yes </s>
Could a Jujutsu expert hypothetically defeat a Janissary?	no </s>
Does the JPEG acronym stand for a joint committee?	yes </s>
Did Mike Tyson train to use the gogoplata?	no </s>
Was the Mentalist filmed in black and white?	no </s>
Would the Ku Klux Klan welcome Opal Tometi into their group?	no </s>
Can an emu chase a bogan?	yes </s>
Is calling ABBA the Swedish Beatles a preposterous claim?	yes </s>
Did Jane Austen suffer from middle child syndrome?	no </s>
Would a pacifist be opposed to hunting?	no </s>
Is a person with St. Vitus's Dance likely to win a ballet competition?	no </s>
Would a retail associate envy the retailer's CEO's pay?	yes </s>
Are there people who are men who experience menstruation?	yes </s>
Was disc jockey Jay Thomas enemies with Clayton Moore?	no </s>
Should cactus soil always be damp?	no </s>
Does the United States Department of Education oversee services benefiting undocumented migrants? 	yes </s>
Does Soylent use Pea for their source of protein? 	no </s>
Are Brian Cranston and Saoirse Ronan's combined Emmy Awards a prime number?	no </s>
Do beeswax alternatives to cling wrap use plsatic?	no </s>
Should you be skeptical of a 21 year old claiming to have a doctorate?	yes </s>
Would Richard Dawkins hypothetically refuse an offering of the Last rites?	yes </s>
Did Christopher Columbus condone multiple deadly sins?	yes </s>
Would an American feel lost due to language barriers at Disneyland Paris?	no </s>
Could you make the kitchen 'holy trinity' without celery?	no </s>
Is Rurouni Kenshin from same country as lead character in Nobunaga's Ambition?	yes </s>
Should you bring your own bags to Aldi?	yes </s>
Would most children be up past their bedtime if they were watching Conan O'Brien?	yes </s>
Did Dale Jr.'s father crash his car due to a stroke?	no </s>
Was latest Republican governor of New Jersey as of 2020 heftiest politician ever?	no </s>
Will a person survive a fever of NY's highest recorded temperature?	no </s>
4 Krispy Kreme glazed doughnuts exceed AHA  daily sugar allowance?	yes </s>
Did Immanuel Kant ever meet the 14th president of the United States?	no </s>
Could a camel fit in a dog house?	no </s>
Would Columbus have discovered Durian trees during his 1492 expedition?	no </s>
Is the current Chief Justice of the United States forbidden from buying alcohol?	no </s>
Could Barron Trump have lived through the Mexican Revolution?	yes </s>
Did Martin Luther believe in Satan?	yes </s>
Does Snoopy look like Chance from Homeward Bound?	no </s>
Were any members of Canidae in Aesop's Fables?	yes </s>
Would United States Air Force consider Return of the Jedi's Han Solo bad hypothetical candidate?	yes </s>
Would Jesus understand the Easter Bunny?	no </s>
Is the Greek alphabet as common as Sumerian cuneiform?	no </s>
Could Sainsbury's buy Tesco?	no </s>
Are all twins the same gender?	no </s>
Are looks the easiest way to tell rosemary from lavender? 	no </s>
Does Nicole Kidman despise Roman Josi?	no </s>
Is a fairy more prevalent in world myths than a valkyrie?	yes </s>
Can you get Raclette in YMCA headquarters city?	yes </s>
Can I build a house on an asteroid?	no </s>
Would someone in CHE101 require a Maya Angelou book?	no </s>
Can too many oranges cause diarrhea?	yes </s>
Could the surface of Europa fry an egg?	no </s>
Can I ski in Steamboat Springs, Colorado in August?	no </s>
Is dopamine snorted nasally by drug users?	no </s>
Is it common for women to have moustaches?	no </s>
Is Michael an unpopular name in the United States?	no </s>
Is Central Park Zoo located on an island?	yes </s>
Can food be cooked in the cosmic microwave background?	no </s>
Is coal needed to practice parachuting?	yes </s>
Would an oil painter avoid reds from scale insects that live on a cactus?	yes </s>
Could you go to New York Public Library and the Six Flags Great Escape in the same day?	yes </s>
Did any of religions in which Himalayas are sacred originate in 19th century?	no </s>
Did brother of Goofy creator's employer commit an excommunicable offense?	yes </s>
Can a Toyota Supra make a vlog?	no </s>
Was Daniel thrown into the lion's den in the New Testament?	no </s>
Would someone on antidepressants need to be cautious of some citrus fruits?	yes </s>
Do people take laxatives because they enjoy diarrhea?	no </s>
Could Durian cause someone's stomach to feel unwell?	yes </s>
Did the swallow play a role in a famous film about King Arthur?	yes </s>
Does the Boy Who Cried Wolf hypothetically have reason to pray to Pan?	yes </s>
Are there enough people in the Balkans to match the population of Japan?	no </s>
Would you hire someone with dyscalculia to do surveying work?	no </s>
Is a paraplegic suitable for conducting an orchestra?	yes </s>
Is Capricorn the hypothetical zodiac sign of Satanism?	yes </s>
Would a sesame seed be mistaken for a wood frog egg?	no </s>
Does Adam Sandler skip celebrating Easter?	yes </s>
Is there historic graffiti on Alcatraz?	yes </s>
Did Queen Elizabeth I read the works of Jean-Paul Sartre?	no </s>
Did Polar Bears roam around in Ancient Greece?	no </s>
Was United Airlines blameless in worst crash in history?	yes </s>
Does New York Harbor sit on a craton without volcanic activity?	no </s>
Would Statue of Liberty be visible if submerged in Bohai Sea?	yes </s>
Have Jamie Lee Curtis been the subject of fake news?	yes </s>
Will the Stanford Linear Accelerator fit on the Golden Gate Bridge?	no </s>
Could JPMorgan Chase give every American $10?	yes </s>
Is the Matrix a standalone movie?	no </s>
Is Noah's Ark an upgrade for Golden Age of Piracy pirates?	yes </s>
Has Nikola Tesla's name inspired multiple brands?	yes </s>
Are all Wednesdays in a year enough to read Bible 15 times?	yes </s>
Do children's bicycles often have extra wheels?	yes </s>
Would most school children in New York be wearing jackets on groundhog day?	yes </s>
Could a white cockatoo have lived through the entire Thirty Years' War?	yes </s>
Did Jesus go to school to study railroad engineering?	no </s>
Can Arnold Schwarzenegger deadlift an adult Black rhinoceros?	no </s>
Can the Palace of Westminster tell time in the dark?	yes </s>
Can a prime number be represented by the number of days in a week?	yes </s>
Would a tool used for Martin Luther's Reformation opening salvo aid in a crucifixion?	yes </s>
Is Edgar Allan Poe obscure in the world of horror fiction?	no </s>
Do all shooting sports involve bullets?	no </s>
Will Ahura Mazda have to look down to see Abaddon's dwelling??	yes </s>
Was Alaska part of the Northern Army during the Civil War?	no </s>
Do Bing (search engine) searches earn the searcher more than competitors do?	yes </s>
Would a loudspeaker be useful for most Gallaudet students?	no </s>
Would three newborn kittens fit on a standard Amtrak coach seat?	yes </s>
Could a newborn look over the top of a fully grown horseradish plant?	no </s>
Does the Red Sea have biblical significance? 	yes </s>
Would moon cakes be easy to find in Chinatown, Manhattan?	yes </s>
Is Bugs Bunny known for carrying a root vegetable around with him?	yes </s>
Would someone buying crickets be likely to own pets?	yes </s>
Are some adherents to Christianity in China historic enemies of Catholic Church?	yes </s>
Can a Kia Rio fit inside the Oval Office?	yes </s>
Were veterans of the War in Vietnam (1945‚Äì46) given free education by the Soviet Union?	no </s>
Is the Easter Bunny popular in September?	no </s>
Is Mozambique Drill an easy shot for United States Army Ranger?	yes </s>
Is lunch on the beach a good activity to spot the full circle of a rainbow?	no </s>
Is the Mona Lisa based on a real person?	yes </s>
Did Johann Sebastian Bach leave his first wife for his second wife?	no </s>
Could Eddie Hall hypothetically deadlift the world's largest cheeseburger?	no </s>
Has Justin Timberlake ever written a song about Britney Spears?	yes </s>
Do most high school head coaches make as much as the Head Coach at NCSU?	no </s>
Did Christopher Columbus break the fifth commandment in Christianity?	yes </s>
Can you transport a primate in a backpack?	yes </s>
Was King Arthur at the beheading of Anne Boleyn?	no </s>
Can the city of Miami fit inside Uppsala?	no </s>
Does Iphone have more iterations than Samsung Galaxy?	no </s>
Is Hanuman associated with a Norse god?	no </s>
Did a Polish poet write sonnets about Islamic religion?	yes </s>
Can you find Bugs Bunny at Space Mountain?	no </s>
Could modern Brazilian Navy have hypothetically turned the tide in Battle of Actium?	yes </s>
Could the children of Greek hero Jason hypothetically fill a polo team?	yes </s>
Can you swim to Miami from New York?	no </s>
Could ABBA play a mixed doubles tennis game against each other?	yes </s>
Is material from an aloe plant sometimes enclosed in petroleum-derived products?	yes </s>
Could Hurricane Harvey catch a Peregrine falcon?	no </s>
Do bodies movie during hanging?	yes </s>
Would Benito Mussolini hypothetically play well in the NBA?	no </s>
Does US brand Nice depend on Western honey bee?	yes </s>
Can Hulk's alter ego explain atomic events?	yes </s>
Can a firewall protect against a short circuit?	no </s>
Would Swiss Guard defeat the Marines?	no </s>
Does conservatism repulse Blaire White?	no </s>
Do skeletons have hair?	no </s>
Did H.G. Wells' "War of the Worlds" include cosmic rays?	no </s>
Does 50 Cent get along with Jeffrey Atkins?	no </s>
Is it normal for people to sing when the YMCA is mentioned?	yes </s>
Do members of NFL teams receive infantry training?	no </s>
Do most religious people in Quebec refer to the Quran?	no </s>
Is a Halloween cruise in the Gulf of Mexico likely to be safe from storms?	no </s>
Can Billie Eilish afford a Porsche?	yes </s>
Did Secretariat win a Formula One championship?	no </s>
Does Robert Downey Jr's Marvel Cinematic Universe character survive the Infinity War?	no </s>
Does James Webb Space Telescope fail astronomer in locating planet Krypton?	yes </s>
Do all crustaceans live in the ocean?	no </s>
Did the population of the Warsaw Ghetto record secret police on cell phones?	no </s>
Was John Lennon known to be a good friend to Sasha Obama?	no </s>
Can spiders help eggplant farmers control parasites?	yes </s>
Does Darth Vader's character resemble Severus Snape?	no </s>
Can a carrot receive an organ transplant?	no </s>
Do people with DID have a good memory?	no </s>
Were items released from Pandora's box at least two of the names of Four Horsemen?	yes </s>
Did the iPhone usher in the scientific revolution?	no </s>
Would someone go to San Francisco for a nature escape?	no </s>
Does parsley sink in milk?	no </s>
Did anyone in the 1912 election take a majority of the popular vote?	no </s>
Could amoebas have played a part in the Black Death?	yes </s>
Did P. G. Wodehouse like the internet as a child?	no </s>
 Is The Invisible Man more prevalent in films than Picnic at Hanging Rock?	yes </s>
Is ABBA's 1970's genre still relevant today?	yes </s>
 Is cactus fruit an important menu item for a restaurant based on Cuauht√©moc?	yes </s>
Did Rumi spend his time in a state of euphoria?	yes </s>
Is silicon important in California?	yes </s>
Would Lord Voldemort have been barred from Hogwarts under his own rules?	yes </s>
Would a modern central processing unit circuit chip fit on a housekey?	no </s>
Are pancakes a bad snack for cats?	yes </s>
Are all students guaranteed lunch at school in the US?	no </s>
Can methane be seen by the naked eye?	no </s>
Could an escapee swim nonstop from Alcatraz island to Siberia?	no </s>
Is there a popular Disney character made from living ice?	yes </s>
Would a blooming onion be possible with a shallot?	no </s>
Did goddess Friday is named after despise felines?	no </s>
Did the Gunpowder plot eliminate Mary, Queen of Scots bloodline?	no </s>
Does Sockington enjoy onions?	no </s>
Would Hapshetsut be considered a monarch?	yes </s>
Can a New Yorker get their eyes checked by Rand Paul legally?	no </s>
Hypothetically, will an African elephant be crushed by Hulk on its back?	no </s>
Would Modafinil be effective in completing a suicide?	no </s>
Were the Ten commandments the part of the bible that Jewish people do not believe in?	no </s>
Did the death of Helen Palmer have a significant effect on Dr. Seuss?	yes </s>
Is the Federal Reserve a quick walk from Space Needle?	no </s>
Would Eric Clapton's mother hypothetically be unable to legally purchase cigarettes in the USA at his birth?	yes </s>
Could Casio's first invention be worn around the ankle?	no </s>
Does Zelda Williams have any cousins on her father's side?	no </s>
Can someone sell their time through the Toronto Star?	yes </s>
Is it wise to feed a Snickers bar to a poodle?	no </s>
Does United Airlines have a perfect operation record?	no </s>
Does Long John Silver's serve sea otter?	no </s>
Would Matt Damon be afraid of parachuting?	yes </s>
Are the colors on Marlboro package found on French flag?	no </s>
Did Richard Wagner compose the theme songs for two television series?	no </s>
Would Recep Tayyip Erdoƒüan be unfamiliar with b√∂rek?	no </s>
Are Naruhito's ancestors the focus of Romance of the Three Kingdoms?	no </s>
Would Felicity Huffman vote for Mike DeWine?	no </s>
Would the host of The Colbert Report be likely to vote for Trump?	no </s>
Was the father of social security system serving in the white house during the Panic of 1907?	no </s>
Do all cancer patients get disability?	no </s>
Did children read Harry Potter and the Philosopher's Stone during the Albanian Civil War?	yes </s>
Would Arnold Schwarzenegger have a hard time picking up a red fox in 1967?	no </s>
Could an NBA game be completed within the span of the Six-Day War?	yes </s>
Would it be difficult for Kami Rita to climb Mount Emei?	no </s>
Is Alistair Darling in favor of Scottish independence?	no </s>
Did any of Maya Angelou's children follow in her footsteps?	yes </s>
Did Methuselah live at least 800 years as long as Sarah?	yes </s>
Is Rosemary outclassed as plant found in most song titles?	yes </s>
Did Switzerland support the United States in the Spanish‚ÄìAmerican War?	no </s>
Is Bill Gates the wealthiest of the Baby Boomers?	no </s>
Is it safe to use Ammonia with Clorox?	no </s>
Did Tony Bennett have more children than he had wives?	yes </s>
Would a greyhound be able to outrun a greyhound bus?	no </s>
Would Bonanza marathon end before WWE Heat marathon?	no </s>
Will Futurama surpass the number of episodes of The Simpsons by the end of 2020?	no </s>
Was Ariana Grande inspired by Imogen Heap?	yes </s>
Can the Communist Party of the Soviet Union get a perfect all kill?	no </s>
Did George W. Bush grow up speaking Cantonese?	no </s>
Would a thesis paper be unusual to assign to kindergartners? 	yes </s>
Do people still see Henry Ford's last name often?	yes </s>
Could a cow produce Harvey Milk?	no </s>
Is it unusual to play Happy hardcore music at a funeral?	yes </s>
Would Communist Party of the Soviet Union hypothetically support Trickle Down Economics?	no </s>
Could a white belt defeat Jon Jones in a Brazilian jiu-jitsu match?	no </s>
Does bull shark bite hurt worse than crocodile bite?	no </s>
Is 1936 Summer Olympics venue too small for a Superbowl crowd?	no </s>
Was Dr. Seuss a liar?	yes </s>
Did Christopher Columbus go to Antarctica? 	no </s>
Is breakdancing safe for people with tendonitis?	no </s>
Is the Louvre's pyramid known for being unbreakable? 	no </s>
Did Naruto escape the Temple of Doom?	no </s>
Is August a winter month for part of the world?	yes </s>
Would Saddam Hussein hypothetically choose Saladin as ally over Idris I?	yes </s>
Do Apollo and Baldur share similar interests?	yes </s>
Are any minor league baseball teams named after felines?	yes </s>
Did Andy Warhol influence Art Deco style?	no </s>
Would Dante Alighieri hypothetically place Rupert Murdoch in 8th Circle of Hell?	yes </s>
Is capturing giant squid in natural habitat impossible with no gear?	yes </s>
Would characters in Harry Potter and the Philosopher's Stone be persecuted as pagans?	yes </s>
Has Aretha Franklin ever collaborated with a suicidal person?	yes </s>
Did the Paramount leader produce Titanic?	no </s>
Do Muslims have a different idea of Seraphim than Christians?	no </s>
Did Julia Roberts practice blast beats as a child?	no </s>
Can a Muslim eat a McRib sandwich?	no </s>
Are there mental disorders you can hide?	yes </s>
Does Hades have a loose grip on the Underworld?	no </s>
Was Surfing popular when pogs came out?	yes </s>
Can Centurylink max internet plan upload 1000GB in a fortnight?	yes </s>
Did Solomon make up bigger percentage of Islamic prophets than Kings of Judah?	no </s>
Has Billy Joel sold out Astana Arena?	no </s>
In star rating systems, is 5 stars considered good?	yes </s>
Does Siri know geometry?	yes </s>
Is a Coca plant farm likely to be found in Yakutsk?	no </s>
Does butter industry survive cow extinction?	yes </s>
Is an internet connection essential for someone using Chrome OS?	yes </s>
Was a USB flash drive used in The Godfather?	no </s>
Would Goofy hypothetically enjoy Nylabone?	yes </s>
Can a software engineer work during a power outage?	no </s>
Would Roman Gallic Wars army struggle to build the pyramids faster?	no </s>
Can telescopes hear noise?	no </s>
Are Big Ben's bells currently rung on their normal schedule at the Palace of Westminster?	no </s>
Would a Drow tower over The Hobbit's hero?	yes </s>
Does March begin on the same day of the week as February during leap years?	no </s>
Can first letter row of QWERTY keyboard spell a palindrome?	yes </s>
Have any members of the 2020 British royal family allegedly committed a felony?	yes </s>
Did any Golden Globe winners attend John Kerry's alma mater?	yes </s>
Is snoring a sign of good breathing while sleeping?	no </s>
Would Stephen King fans be likely to own an image of a clown?	yes </s>
Is the US Secretary of State similar to an administrative secretary of an office?	no </s>
Would it be impossible to get to Burning Man on the Mayflower?	yes </s>
Are hippos dangerous to humans?	yes </s>
Can a sniper shoot a fish past Bathypelagic Zone in ocean?	no </s>
Has the Holy Grail been featured in at least five films?	yes </s>
Does American Independence Day occur during autumn?	no </s>
Did Karl Marx influence the communist party of China?	yes </s>
Are the Great Lakes part of an international border?	yes </s>
Can Curiosity (rover) kill a cat?	yes </s>
Is Albany, Georgia the most populous US Albany?	no </s>
Was King Kong climbing at a higher altitude than Eiffel Tower visitors?	yes </s>
Would Constitution of the United States paper offend PETA?	yes </s>
If you bottle your own milk, would there be cream on top of it?	yes </s>
Is Nine Inch Nails's lead singer associated with David Lynch?	yes </s>
Is Pan a symbol of virtue and virginity in women?	no </s>
Do people put creatures from the Black Sea on their pizza?	yes </s>
Should wool be hand washed only?	yes </s>
Are paratroopers good at mountain rescue?	yes </s>
Is the Berlin University of the Arts a Baroque period relic?	yes </s>
Can a student from Smithtown's Cleary School understand the speech of a French person?	no </s>
Would Dante have hypothetically placed Nostradamus in 3rd Circle of Hell?	no </s>
Can a rabbi save the soul of a Christian?	yes </s>
Could the Austrian casualties from Seven Years' War fit in Indianapolis Motor Speedway?	yes </s>
Did the butler Eugene Allen retire the same year a centuries-old war ended?	yes </s>
Does title of Van Morrison's most played song apply to a minority of women worldwide?	no </s>
Does Hanuman have some of the same duties as Athena?	yes </s>
Do workers at Nissan's headquarters eat with chopsticks?	yes </s>
Would Edward II of England have been born without Vikings?	no </s>
Do black swan cygnets typically know both of their genetic parents?	no </s>
Is the most recent Democrat President in the US known for his painting practice?	no </s>
Could pickled cucumbers from 1,000 years ago be good still?	no </s>
Can numerologists become members of Royal Society?	no </s>
If someone is lactose intolerant, do they have to avoid cream?	yes </s>
Could Jamie Brewer have attended the United States Naval Academy?	no </s>
Did Elle Fanning play an essential part in ending apartheid?	no </s>
Did the 23rd amendment give Puerto Ricans the right to vote for president?	no </s>
Could Edward Snowden join MENSA?	yes </s>
Were French people involved in the American Civil War?	yes </s>
Is helium the cause of the Hindenburg explosion?	no </s>
Does Southwest Airlines use bulk carriers?	yes </s>
Is dysphoria around one's pelvis treatable without surgery?	yes </s>
Is the QWERTY keyboard layout meant to be slow?	yes </s>
Can I find my home with latitude and longitude?	yes </s>
Did the Wall Street Crash of 1929 hurt the stocks of robotics companies?	no </s>
Could Snoopy transmit rabies?	no </s>
Would Bruce Gandy be an odd choice for Messiah (Handel)?	yes </s>
Is popular science used to peer review papers?	no </s>
Do the Egyptian pyramids look the same from outside as they did when new?	no </s>
Would an average American Public University be welcoming to Ku Klux Klan members?	no </s>
Would a lullaby be enough to wake Hellen Keller up?	no </s>
Is accountant a difficult profession for a person suffering from Dyscalculia?	yes </s>
Would Robert Wadlow tower over a German Shepherd?	yes </s>
Did the Cherokee people send a delegation to oppose allotment?	yes </s>
Can the Moscow Kremlin fit inside Disney Land?	yes </s>
Is euphoria associated with drug addiction?	yes </s>
Does Billy Graham support agnosticism?	no </s>
Is Ganymede in the Milky Way galaxy?	yes </s>
Can you avoid internet trolls on reddit?	no </s>
Could Javier Sotomayor jump over the head of the average giraffe?	no </s>
Could Goofy have counted nine planets in his first year?	yes </s>
Did Douglas Adams use email as a child?	no </s>
Would Kurt Cobain have benefited from Project Semicolon?	yes </s>
Could the Eiffel Tower be completely submerged at the Arctic Ocean's deepest point?	yes </s>
Would a goblin shark eat at Crossroads Kitchen?	no </s>
Is jalapeno heat outclassed by Bhut jolokia?	yes </s>
If you're running focal fossa, are you using linux?	yes </s>
Are birds important to badminton?	yes </s>
Would you buy bananas for tostones?	no </s>
Is Dungeons and Dragons a game well suited for solo play?	no </s>
Would vegans consider chickpeas for a tuna substitute?	yes </s>
Does giant panda have colors that differ from yin yang?	no </s>
Did Nine Inch Nails inspire Aretha Franklin's sound?	no </s>
Was Hundred Years' War a misnomer?	yes </s>
Would Lee Sedol understand the complexities of the Sicilian Defence?	no </s>
Would menu at Chinese Starbucks be familiar to an American?	no </s>
Are Saturn's famous rings solid?	no </s>
Was Noah associated with a dove?	yes </s>
Was Achilles a direct descendent of Gaia?	yes </s>
Do any Islamic dominated countries have a Starbucks?	yes </s>
Is a thousand dollars per Days of Our Lives episodes preferred to other soaps?	no </s>
Is pickled cucumber ever red?	yes </s>
Does welding with acetylene simulate the temperature of a star?	yes </s>
Is it comfortable to wear sandals outside Esperanza Base?	no </s>
Would an art dealer prize a print of a Van Goh? 	no </s>
Would Jean Harris's victim have avoided lentils?	yes </s>
Would Marvel's Gateway be envious of the Doctor (Doctor Who)'s TARDIS machine?	no </s>
Did Supernatural break 2001 CW debuting shows seasons record?	yes </s>
Did Alfred Hitchcock include internet slang in his films?	no </s>
Is Norman Oklahoma named after a viking?	no </s>
Can every digit in Pi be memorized?	no </s>
Do people associate greyhounds with the movie 'Homeward Bound'?	no </s>
Did Alan Turing suffer the same fate as Abraham Lincoln?	no </s>
Does meat from cows fed only grass taste more like wild game?	yes </s>
Can 200 men end to end cover Great Pyramid of Giza's base?	yes </s>
Would World War II have been the same without Alan Turing?	no </s>
Could every citizen of Samoa send a letter to a unique JPMorgan Chase employee?	yes </s>
Would East India Company prefer China's modern trade?	no </s>
Is metal a type of folk music?	no </s>
Did George Washington drive a Lexus?	no </s>
Are there special traffic laws associated with funerals?	yes </s>
Can Chinese mountain cat survive in the orbit? 	no </s>
Can ham make a cut seal up quicker?	yes </s>
Was 1941 Operation Barbarossa related to The Crusades?	yes </s>
Would an actuary be confused about what prime numbers are?	no </s>
Can Ford F-350 tow entire Yale University student body?	no </s>
Could Chuck Norris ride a horse?	yes </s>
Do salmon mate in the Caspian Sea?	no </s>
Would Michael J Fox qualify for the Army Rangers?	no </s>
Would a model be appropriate to star in a LA Femme Nikita remake?	yes </s>
Is CAS number 8009-03-8 harmful for a rash?	no </s>
Is Drew Carey important to the history of wrestling?	yes </s>
Would Iggy Pop travel with Justin Bieber?	no </s>
Will a Euro sink in water?	yes </s>
Did Larry King sign the Magna Carta?	no </s>
Did Jackie Kennedy wear Dolce & Gabbana to her husband's inauguration?	no </s>
Do quadragenarian's have little memory capacity?	no </s>
Was  Godfrey of Bouillon an Islamaphobe?	yes </s>
Is the skull formed as one whole bone?	no </s>
Is The Joy of Painting TV show still producing new episodes?	no </s>
Does James Watson believe that Africans are inferior to Europeans?	yes </s>
Was the Eiffel tower used as a symbol of the French Revolution?	no </s>
Will Al Pacino and Margaret Qualley score same amount of Bacon Number points?	yes </s>
Would Carolina Reaper decrease sales if added to all US salsa?	yes </s>
Would fans of Jonathan Larson be unaware of HIV?	no </s>
Can Josh Blue participate in Paralympics Games? 	yes </s>
Can you hide a pet macaque under your desk?	yes </s>
Does horseradish have a fetlock?	no </s>
Can a diamond float on water?	no </s>
Is Canon Inc. a Kabushiki gaisha?	yes </s>
Is it possible to get killed walking to the Very Large Telescope?	yes </s>
Is it possible that June got its name from mythology?	yes </s>
Could Reza Shah be related to Queen Elizabeth I?	no </s>
Was Anthony Quinn more prolific at making children than J.D. Salinger?	yes </s>
Does menthol make cigarettes less addictive?	no </s>
Did France win the French Revolution?	no </s>
Do people celebrate Earth Day with a ceremonial tire fire?	no </s>
Would you find olives at a heladeria?	no </s>
Was Pope Alexander VI's origin country least represented in papal history?	no </s>
Is Newspeak considered very straightforward?	no </s>
Is myocardial infarction a brain problem?	no </s>
Did Northwest Airlines' longevity surpass Betty White?	no </s>
Could you windsurf in Puerto Rico during Hurricane Maria?	no </s>
Do tourists prefer Tuvalu to Niue?	no </s>
Were muskets used in the Pacific War?	no </s>
Does autopilot rely on fossil fuels?	yes </s>
Can nitric acid break the Louvre?	yes </s>
Would a Durian be dangerous if it fell on your head?	yes </s>
Did the Coen brothers ever collaborate with the Brothers Grimm?	no </s>
Can an Asian black bear use chopsticks?	no </s>
Are rainbows devoid of color made by mixing yin and yang colors?	yes </s>
Does Jerry Seinfeld hang out at the Budweiser Party Deck?	no </s>
Do most fans follow Katy Perry for gospel music?	no </s>
Does the Eighth Amendment to the United States Constitution protect freedom of speech?	no </s>
Could all of the famous Apollo's hypothetically defeat all of the famous D'Artagnan's?	yes </s>
Can Family of Barack Obama ride comfortably in 2020 Jaguar F Type?	no </s>
Do Elementary School students typically need graphing calculators?	no </s>
Would King Leonidas have succeeded with an army the size of Mozart's compositions?	no </s>
Did the leader of Heaven's Gate consider himself a prophet?	yes </s>
Are the names of The Powerpuff Girls alliterative? 	yes </s>
Would Cardi B. benefit from soy milk?	yes </s>
Phileas Fogg's around the world would be difficult to achieve during Pope John Paul I's reign?	yes </s>
Are deaf people left out of enjoying music?	no </s>
Can someone with celiac disease have potato vodka?	yes </s>
Are cucumbers often found in desert?	no </s>
Is it bad to have lactic acid in your body?	no </s>
Can someone with dermatitis be a hand model?	no </s>
Does ancient Olympics crown fail to hide tonsure?	yes </s>
Can dessert be made with vegetables?	yes </s>
Was proofreading Edgar Allan Poe works lucrative?	no </s>
Can Roman numerals fill the normal number of Sudoku box options?	no </s>
Does being good at guitar hero make you a good guitarist?	no </s>
Did any citizen of San Antonio vote for Boris Johnson?	no </s>
Will Justin Bieber take over Mike Pence's position in 2020?	no </s>
Was Mozart accused of stealing from Richard Wagner?	no </s>
Do seven McDonald's hamburgers exceed USDA recommended fat allowance?	no </s>
Can children become lieutenants?	yes </s>
Could SNL be why Jenny McCarthy does not get along with her cousin?	yes </s>
Would Phineas and Ferb enjoy winter?	no </s>
Is H's most common two letter pair partner a freebie in Wheel of Fortune bonus round?	yes </s>
Can Curiosity take samples of rocks from Lacus Temporis?	no </s>
Is the title of Shirley Bassey's 1971 diamond song a true statement?	no </s>
Can Tame Impala's studio band play a proper game of Hot Potato?	no </s>
Can a cell fit inside of a shoebox?	yes </s>
Is US route 1 dominated by historically red states?	no </s>
Is overfeeding Lactobacillus unwise for people without dental insurance?	yes </s>
Does Pikachu like Charles Darwin?	yes </s>
Is nickel a better payout than mercury if given a dollar per atomic number?	no </s>
Would a duck ever need a Caesarean section?	no </s>
Can Aerosmith fit in a 2020 Mitsubishi Outlander?	yes </s>
Could all of the people who pass through 30th Street Station every day fit in Dorton Arena?	no </s>
Did any of the amazons on Xena: Warrior Princess star on later shows?	yes </s>
Can you purchase General Motors products at a movie theater?	no </s>
Would a CEO typically clean the toilets in a company's building?	no </s>
Was Dioskourides a lapidary?	yes </s>
Could Quartz be useful to humans if plants died off and there was no oxygen?	yes </s>
Can United States Secretary of State do crimes in U.K. without being arrested?	yes </s>
Can you see the moon in Wembley Arena?	no </s>
Does Homer Simpson need two hands worth of fingers to count to 5?	yes </s>
Does open heart surgery finish before entirety of American Ballet Theatre's Swan Lake?	no </s>
Is Rand Paul guilty of catch-phrase used to attack John Kerry in 2004?	yes </s>
Does Robert De Niro use a microscope at work?	no </s>
Would Gordon Ramsey use uranium as a seasoning?	no </s>
Would Jacques Du√®ze have been friends with Richard Dawkins?	no </s>
Was Robert Downey Jr. a good role model as a young man?	no </s>
Did Melania Trump have same profession as Olga Kurylenko?	yes </s>
Is the BBC World Service hosted in Europe?	yes </s>
Was Mother Theresa a follower of atheism?	no </s>
Is it possible to binge entire EastEnders series without water?	no </s>
Would stargazers prefer binoculars over a telescope?	no </s>
Would Carrie Poppy be likely to trust a psychic?	no </s>
Did Francois Mitterrand ever meet Barak Obama while they both held the position of President?	no </s>
Was Jackson Pollock trained by Leonardo da Vinci?	no </s>
Is the Mona Lisa in the same museum as the Venus de Milo?	yes </s>
Did Confederate States Army influence West Point fashion?	yes </s>
Is it possible for biologist Rachel Carson to have flown to the moon?	no </s>
Can 1980 United States presidential election result be considered a photo finish?	no </s>
Could a monolingual American read Lenovo's native name?	no </s>
Would an environmentalist advocate for preventing domestic canine reproduction?	yes </s>
Are there options for students who struggle to understand the writing style of Othello?	yes </s>
Would most grand masters know what the French Defense is?	yes </s>
Is MF Doom a Fantastic Four villain?	no </s>
Is Snow White an example of good consent?	no </s>
Will Gremlins sequels tie number of Matrix sequels?	yes </s>
Is the tree species that the name Leipzig refers to an evergeen tree?	no </s>
Can Kate Gosselin's household fill out a Bandy team?	no </s>
Is Michael Vick on People for the Ethical Treatment of Animals's hypothetical blacklist?	yes </s>
Was dynamite used during Middle Ages warfare?	no </s>
Would Downton Abbey finale viewership defeat every Kazakhstan citizen in tug of war?	no </s>
Is MIX a word and a roman numeral?	yes </s>
Could Little Women have been a book read by veterans of the civil war?	yes </s>
Will a celibate cleric likely suffer a stoning in Somalia?	no </s>
Would a Gray Whale fit easily in an above ground pool?	no </s>
Do you need lactobacillus to make pickles?	no </s>
Did Holy Saturday 2019 have special significance to pot smokers?	yes </s>
Did people in Korea under Japanese Rule watch a lot of Iron Chef?	no </s>
Is shoe soup innocuous?	yes </s>
In a hypothetical race between a Swallow and an American Woodcock, would the Swallow win?	yes </s>
Can a sea turtle play tennis using a tennis racket?	no </s>
Are right wing Amreicans opposed to marxism?	yes </s>
Are there Americans still enlisted in the Confederate States Army?	no </s>
Can Stone Cold Steve Austin apply his finisher to a mule deer?	yes </s>
Did President William Howard Taft read DC Comics?	no </s>
Did Barack Obama participate in the Reformation?	no </s>
Could you watch a new Seinfeld episode every day for a year?	no </s>
Are honey badgers and hyenas anatomically dissimilar? 	no </s>
If Martin Luther did one theses a day would he run out in half a year?	yes </s>
Would a 75 degree Fahrenheit day be unusual on the Antarctic Peninsula? 	yes </s>
Did earth complete at least one orbit around the sun during the Napoleonic Wars?	yes </s>
Would a Dodo hypothetically tower over Ma Petite?	yes </s>
Can you find Depala's race in World of Warcraft?	yes </s>
Did Klingons appear in the movie The Last Jedi?	no </s>
If one of your feet is in a leg cast, should the other be in a sandal?	no </s>
Would a triples tandem bike support Apollo 15 crew?	yes </s>
Would a spider wasp be more effective than a bullet ant to stop a criminal?	no </s>
Would Library of Alexandria need less shelf space than Library of Congress?	yes </s>
Are all cucumbers the same texture?	no </s>
Do calico cat patterns cover every drain fly color variety?	no </s>
Can you fit every resident of Auburn, New York, in Tropicana Field?	yes </s>
Would a Beaver's teeth rival that of a Smilodon?	no </s>
Can an Arvanite Greek understand some of the Albanian Declaration of Independence?	yes </s>
Does Pantheon in Paris have a unique name?	no </s>
Were there footprints on the moon in 1960?	no </s>
Was Darth Vader monogamous?	yes </s>
Would a vegan eat a traditional Paella dish?	no </s>
Is B's place in alphabet same as Prince Harry's birth order?	yes </s>
Was Mark Twain a struggling inventor?	no </s>
Did Al Capone carry a smartphone?	no </s>
Can Burundi's communicate with citizens of New Brunswick?	yes </s>
Can Michael Bloomberg fund the debt of Micronesia for a decade?	yes </s>
Would a physician be unlikely to recommend Reiki?	yes </s>
Could Ryan Crouser throw a bengal fox with ease?	yes </s>
Would Jimmy Vee be eligible to compete in the Paralympic Games?	yes </s>
Can a jet plane be made without society?	no </s>
Would a duke hypothetically be subservient to a Tsar?	yes </s>
Is the Louvre in billionaire George Soros's price range?	no </s>
Are quadrupeds represented on Chinese calendar?	yes </s>
Are Scottish people descended from Mary, Queen of Scots part French?	yes </s>
Can actress Dafne Keen win the Eurovision Song Contest finals in 2020?	no </s>
Was Amy Winehouse familiar with Brexit?	no </s>
Would a student in eleventh grade be unable to run for president of the United States?	yes </s>
Would a cauliflower farmer prosper at a latitude of 75¬∞ N?	no </s>
Did Jack Dempsey fight the current WBC heavyweight champion?	no </s>
Could a cat ride Panzer VIII Maus tank missile from Barcelona to Madrid?	no </s>
Did Elizabeth I of England own any viscose fiber?	no </s>
Is sternum connected to any of the bones mentioned in James Weldon Johnson's Dem Bones?	yes </s>
Has the creator of Futurama lived in multiple centuries?	yes </s>
Did Pink Floyd have a song about the French Riviera?	yes </s>
Is electricity necessary to balance an account in Microsoft Excel?	yes </s>
Was historical Dracula from a town in Bucharest?	no </s>
Did Richard Wagner support the Nazis?	no </s>
If Goofy were a pet, would he need heartworm prevention?	yes </s>
Has Alan Greenspan lived through at least a baker's dozen of president's?	yes </s>
Did Bill Gates achieve Latin honors?	no </s>
Was the son of Tsar Nicholas a daredevil?	no </s>
Does the judo rank system reach the triple digits?	no </s>
Did Cleopatra have ethnicity closer to Egyptians than Greeks?	no </s>
Can soup be eaten with the hands?	no </s>
If your electric stove has a glass top, should you use cast iron skillets?	no </s>
Did Woodrow Wilson consider Blacks to be equal members of society?	no </s>
Would an astrologer focus on the densest terrestrial planet for a Friday horoscope?	yes </s>
Was Elizabeth II the Queen during the Persian Gulf War?	yes </s>
Could an ocelot outrun a kindergartner? 	yes </s>
Can music be used as a weapon?	yes </s>
Can the United Nations Framework Convention on Climate Change be held at the Javits Center?	no </s>
Was San Antonio the site of a major battle in the 19th century?	yes </s>
Did Emma Stone pursue a higher education?	no </s>
Is Cambodia too expensive for 2020 richest billionaire to own?	no </s>
Would you have to wear a coat when on Phobos?	yes </s>
Would Mary, mother of Jesus have hypothetically prayed to Artemis if she was Greek?	yes </s>
Is a beard is moss that grows on a human?	no </s>
Did Archduke Franz Ferdinand of Austria participate in the Pacific War?	no </s>
Does The Doctor keep his ship in his childhood home?	no </s>
Does Marco Rubio have a close relationship with Allah?	no </s>
Is shrimp prevalent in Ethiopian cuisine?	no </s>
Can pancreas removal cause bankruptcy?	yes </s>
Do suburbs encourage the use of cars?	yes </s>
Is Gandalf hypothetically a formidable foe for Charmed's Barbas?	no </s>
Would a moose hypothetically be too much for a minotaur to devour whole?	yes </s>
Can you worship Ahura Mazda at a mosque?	no </s>
Would a hedgehog avoid animals without a spinal cord?	no </s>
Does Fraktur have a sordid history?	yes </s>
Was the Peak of the Andes hidden from the view of the Colossus of Rhodes?	yes </s>
Is LG Electronics located in a city with an official bird that has a purplish/blue tail?	yes </s>
Could you watch Naruto and Puzzle Place on the same channel?	no </s>
Could Christopher Nolan borrow pants from Danny Devito?	no </s>
Was the Joker an enemy of the Avengers?	no </s>
Will twenty pea pods contents cover entire chess board?	yes </s>
Is Phobos (moon) name origin similar to Roman god Pavor?	yes </s>
Can binary numbers and standard alphabet satisfy criteria for a strong password?	no </s>
Would a diet of ice eventually kill a person?	yes </s>
Would an adherent of Zoroastrianism consult the Quran for religious guidance?	no </s>
Is the Joker in a healthy romantic relationship?	no </s>
Were Greeks essential to crafting Egyptian Lighthouse of Alexandria?	yes </s>
Did J. D. Salinger ever ask his father for a quincea√±era?	no </s>
Does a game engine have a fuel injector?	no </s>
Would drinking a glass of lemonade provide Vitamin C?	yes </s>
Is Chinese successor to Chevrolet Cruze name a town far from Milan?	no </s>
Could Tom Cruise explain mental auditing?	yes </s>
Are human footprints absent from Mount Sharp?	yes </s>
Did the crew of Apollo 15 take pictures of Mount Sharp?	no </s>
Do carpenters understand geometry?	yes </s>
Do people of the Iyer caste eat meat?	no </s>
Is a pottery kiln inappropriate for use with glass blowing?	no </s>
Would WWF be angrier if you killed koala instead of black swan?	yes </s>
Are twins always born during the same year?	no </s>
Does acupuncture cause pain in many people?	no </s>
Would a clouded leopard encounter an awake pangolin?	yes </s>
Would a crocodile survive longer in Great Salt Lake than alligator?	yes </s>
Did The Who have to cancel tours due to World War II?	no </s>
Has numerology helped shape hotel layouts?	yes </s>
Did Operation Barbarossa or Barbarossa's last expedition succeed?	no </s>
Are anchovies associated with Italian food?	yes </s>
Can chemicals in onion help create a thermonuclear bomb?	yes </s>
Would it be difficult to snowboard on Venus?	yes </s>
Were any of despised Pope Alexander VI's descendants canonized?	yes </s>
Is Saturn named after king of gods in Greek mythology?	no </s>
Is there any absolute way to prevent abortion?	no </s>
Did any killer Manson band members were named for exceed Charles Manson's kills?	yes </s>
Could James Brown's ex-wives hold a doubles game of tennis?	yes </s>
Do bald eagles nest on Mount Sharp?	no </s>
Could Plato have agreed with the beliefs of Jainism?	yes </s>
Would a Wolverine and a Lynx be hard to tell apart?	no </s>
Can you go water skiing on Venus?	no </s>
Can shooting bald eagle get a person more prison time than Michael Vick?	yes </s>
Is "A Tale of Two Cities" a popular science novel?	no </s>
Would Topa Inca Yupanqui have encountered the western honey bee?	no </s>
Did eggs need to be kept cold in the middle ages?	no </s>
Could the Port of Baltimore handle the entire world's cargo production of ginger each year?	yes </s>
Does store bought milk have cream at the top?	no </s>
Are more watermelons grown in Brazil than Antarctica?	yes </s>
On August 20, 2020,  does The Tonight Show Starring Jimmy Fallon air after moonset EST?	yes </s>
Were paparazzi directly responsible for the death of Amy Winehouse?	no </s>
Did the phone Alexander Graham Bell use have call waiting?	no </s>
Is zoology unconcerned with strigoi?	yes </s>
Is it safe to eat kidney?	yes </s>
Has Gorillaz creator been in more bands than Bernard Sumner?	yes </s>
Does Abdulqawi Yusuf go to the Hague on a typical work day?	yes </s>
Are Disney's seven dwarves the original ones?	no </s>
Does Guam have a state capital?	no </s>
Did Heracles famous labors exceed a baker's dozen?	no </s>
Could the Great Wall of China connect the Dodgers to the White Sox?	yes </s>
If a baby was born on Halloween would they be a Scorpio?	yes </s>
Can bottlenose dolphins hypothetically outbreed human women?	no </s>
Did Johnny Carson win enough Emmy's to fill a carton if Emmy's were eggs?	no </s>
Was Mercedes-Benz associated with the Nazis?	yes </s>
Could Buzz Aldrin have owned a computer?	yes </s>
Can a cheetah generate enough force to topple Big Show?	yes </s>
Is Elijah part of a Jewish holiday?	yes </s>
Did J. Edgar Hoover take his calls in Langley, Virginia?	no </s>
Does a kangaroo incubate its offspring?	no </s>
Is basil safe from Hypervitaminosis D?	yes </s>
Is Garfield known for hating italian cuisine?	no </s>
Is Mark Cuban able to visit Northern Mariana Islands without a passport?	yes </s>
Were deaths from Apollo 13 mission eclipsed by other space missions?	yes </s>
Is Final Fantasy VI closer to beginning than end of its franchise?	yes </s>
Is Tange Sazen hypothetically an ideal choice for a secretary job?	no </s>
Has Don King killed more people than Charles Manson did with his own hands in 1971?	yes </s>
Are sea turtles enjoying life during quarantine?	yes </s>
Can a blind person tell time by Big Ben?	yes </s>
Are Tom and Jerry featured in a ride at Disneyland?	no </s>
Would downloading Mario 64 on an emulator be legal?	no </s>
Could Johnny Carson's children fill out a water polo team?	no </s>
Could someone in a coma experience fear?	no </s>
Do many fans of J.K Rowling know who Alan Rickman is?	yes </s>
Are months based on the solar cycle?	no </s>
Would a 900,000 pound net worth person be an American billionaire if they exchange currency June 2020?	yes </s>
Is there a popular Broadway character who is a missionary?	yes </s>
Would somebody leave reiki with bruises?	no </s>
Would Robert Stack have been interested in Tower of London during 1400s for his 14 season show?	yes </s>
Would a stool be useful for a Lusotitan to reach the top of an almond tree?	no </s>
Could ancient Tony Bennett have a baby in 2020?	yes </s>
Are eagles and young bears both used as labels for skills-training youth groups?	yes </s>
Do movies always show nerds as the losers?	no </s>
Is it safe to share silverware with an HIV positive person?	yes </s>
Would many meals heavy in brussels sprouts benefit someone on Coumadin?	no </s>
Can Immersion Baptism lead to a death like Jeff Buckley's?	yes </s>
When Hugh Jackman was a teacher, would he have taught The Great Gatsby?	no </s>
Would Arnold Schwarzenegger be unable to run for President of the US?	yes </s>
Is capsaicin associated with cooking?	yes </s>
Does a person need a college degree to become a bartender?	no </s>
Would a German Shepherd be welcome in an airport?	yes </s>
Would Hodor hypothetically be a good math mathematician?	no </s>
Would a Rockette look odd with a moustache? 	yes </s>
Is sound barrier too much for Audi R8 V-10 Plus to break?	yes </s>
Can printing books in kanji instead of the Roman alphabet save trees?	yes </s>
Is a Chinchilla breed of felis catus a type of rodent?	no </s>
Is watermelon safe for people with a tricarboxylic acid allergy?	yes </s>
Can the Dalai Lama fit in a car?	yes </s>
Does the Roman god Vulcan have a Greek equivalent?	yes </s>
Does Hammurabi's Code violate Christians Golden Rule?	yes </s>
Would the fastest tortoise win a race against a Chicago "L"?	no </s>
Did Malcolm X use Unicode?	no </s>
Is there a jukebox musical about a sweet transvestite from Transexual, Transylvania?	no </s>
Would an aerodynamic cactus benefit from more frequently closed stomata?	yes </s>
Do drummers need spare strings?	no </s>
Was the subject of Parsifal taken from British folklore?	yes </s>
Is it normal to find parsley in multiple sections of the grocery store?	yes </s>
Was Raphael's paintings influenced by the country of Guam?	no </s>
Would someone on a keto diet be able to eat Dosa?	no </s>
Are kayaks used at the summit of Mount Everest?	yes </s>
Is an inappropriate lullaby Love Song from November 11, 2000?	yes </s>
Would a vegan prefer a natural bongo drum over a synthetic one?	no </s>
Is Bern a poor choice for a xenophobic Swiss citizen to live?	no </s>
Could all People's Volunteer Army hypothetically be transported on Symphony of the Seas?	no </s>
Did Kim Il-sung network on LinkedIn?	no </s>
Is Christopher Nolan indebted to Bob Kane?	yes </s>
Would the average Hawaiian male experience more days on Earth compared to a wild cane toad?	yes </s>
Is slitting your wrists an unreliable suicide method?	yes </s>
Was it typical to see Johnny Cash on stage in a rainbow-colored outfit?	no </s>
Was Woodrow Wilson sandwiched between two presidents from the opposing party?	yes </s>
Do worshipers of Shiva make a pilgrimage to the Holy Land?	no </s>
Would a compass attuned to Earth's magnetic field be a bad gift for a Christmas elf??	yes </s>
Is RoboCop director from same country as Gaite Jansen?	yes </s>
Does Mercury make for good Slip N Slide material?	no </s>
Does Happy Gilmore Productions CEO own a Torah?	yes </s>
Do most people only memorize slightly over half of their ZIP code?	yes </s>
Would a snake have reasons to fear a honey badger?	yes </s>
Has Burger King  contributed to a decrease in need for snowshoes?	yes </s>
Did Pablo Escobar's nickname collection outshine Robert Moses Grove's?	yes </s>
Does cell biology teach about the life cycle of Al Qaeda?	no </s>
Could Godzilla have been killed by the Tohoku earthquake?	no </s>
Can a person be diagnosed with a Great Depression?	no </s>
Could Marco Rubio ride the Candymonium roller coaster at Hershey Park?	yes </s>
Was the amount of spinach Popeye ate unhealthy?	yes </s>
Is the voice of the Genie from Disney's Aladdin still alive?	no </s>
Could a snowy owl survive in the Sonoran?	no </s>
Can any person with a driver's license work in transport of aviation fuel?	no </s>
Has every astronaut survived their space journey?	no </s>
Would hypothermia be a concern for a human wearing zoot suit on Triton?	yes </s>
Could the Spice Girls compete against ≈ΩRK Kumanovo?	no </s>
Was Amazon involved in the lunar landing?	no </s>
Could all Tahiti hotels hypothetically accommodate US D-Day troops?	no </s>
Is a bengal fox likely to see the Superbowl?	no </s>
Did Harvey Milk ever run for governor?	no </s>
Is Nine Inch Nails a good guest for students in earliest grade to take Iowa tests?	no </s>
Did the Beatles write any music in the Disco genre?	no </s>
Are leaves from coca good for gaining weight?	no </s>
Do embalmed bodies feel different at funerals?	yes </s>
Did Stone Cold Steve Austin wrestle in three different centuries?	no </s>
Can Kane challenge Joe Biden in this year's primaries?	no </s>
Did Richard III know his grandson?	no </s>
Has Ringo Starr been in a relatively large number of bands?	no </s>
Are pancakes typically prepared in a pot?	no </s>
Is Christmas always celebrated on a Sunday?	no </s>
Would someone in Boston not receive the Toronto Star?	yes </s>
Will Lhamo Thondup be considered by Catholic Church to be a saint?	no </s>
Is a spice grinder ueseless for the cheapest cinnamon sticks?	yes </s>
Is the Sea of Japan landlocked within Japan?	no </s>
Did the first Duke of Valentinois play a key role in the Hundred Years' War?	no </s>
Can you substitute the pins in a bowling alley lane with Dustin Hoffman's Oscars?	no </s>
Did Rosalind Franklin contribute to work that led to Whole Genome Sequencing?	yes </s>
Is the most expensive color in the world Blue?	yes </s>
Was the French Revolution televised?	no </s>
Do the Eskimos sunbathe frequently?	no </s>
Will the small intenstine break down a cotton ball?	no </s>
Is University of Pittsburgh easier to enter than FBI?	yes </s>
Do women often need new shoes during their pregnancy?	yes </s>
Would Seroquel be the first treatment recommended by a doctor to someone with depression?	no </s>
Do you have to put on glasses to read a QR code?	no </s>
Can an anchovy born in 2020 survive 25th US census?	no </s>
Can a minor replicate the double-slit experiment?	yes </s>
Do Squidward Tentacles and Alan Greenspan have different musical passions?	no </s>
Is Shakespeare famous because of the infinitive form?	yes </s>
Did Gandhi watch the television show Bonanza?	no </s>
Do you need a farmer to make a circuit board?	no </s>
Would LeBron James hypothetically glance upwards at Yuri Gagarin?	no </s>
Is Ludacris in same music genre as 2000's Binaural?	no </s>
Did Brad Peyton need to know about seismology?	yes </s>
Is someone more likely to survive having breast cancer in Japan than in Sweden?	no </s>
Could $1 for each 2009 eclipse buy a copy of TIME magazine in 2020?	yes </s>
Does Olympia Washington share name with Hephaestus's workshop location?	yes </s>
Was Saudi Aramco started due to an assassination?	yes </s>
Is Hermione Granger eligible for the Order of the British Empire?	no </s>
Did Linnaeus edit Darwin's draft of Origin of Species?	no </s>
Is the Riksdag a political entity in Scandinavia?	yes </s>
Is a jellyfish safe from atherosclerosis?	yes </s>
Would Dave Chappelle pray over a Quran?	yes </s>
Can Justin Timberlake ride Shipwreck Falls at Six Flags?	yes </s>
Can dementia be cured with a cast?	no </s>
Does D√ºsseldorf have only a small number of smoggy days each year?	yes </s>
Can a false pope become a saint?	yes </s>
Can a snake wear a snowshoe?	no </s>
Can a wheelbarrow full of starch kill hyperglycemics?	yes </s>
Do giraffes require special facilities at zoos?	yes </s>
Is Bactrian Camel most impressive animal when it comes to number of humps?	no </s>
Would a responsible bartender make a drink for Millie Bobby Brown?	no </s>
Would Ibn Saud tolerate salsa music?	no </s>
Was Aristotle a member of the House of Lords?	no </s>
Was Krishna skilled at using the bow?	yes </s>
Is dessert eaten before breakfast?	no </s>
Does Disney's Alice in Wonderland involve the celebration of a holiday?	yes </s>
Could Bob Marley's children hypothetically win tug of war against Kublai Khan's children?	no </s>
Does USA fail separation of church and state in multiple ways?	yes </s>
Do Star Wars fans say "beam me up" often?	no </s>
Are gorillas closely related to humans?	yes </s>
Are goats found on abyssal plains?	no </s>
Did Saint Augustine use the Julian calendar?	yes </s>
Did Donald Trump come up with the idea for the New York Harbor?	no </s>
Can a woman on average have a baby before wheat seed blooms?	no </s>
Would it be safe to have a jackfruit thrown at your head?	no </s>
Was the first Vice President of the United States an Ottoman descendant?	no </s>
Are all United States Aldi locations owned by the same company?	no </s>
Could Saint Peter watch television?	no </s>
Will NY Stock Exchange closing bell be heard in Universal Music Group's headquarters?	no </s>
Does Super Mario protagonist hypothetically not need continuing education classes in Illinois?	no </s>
Can you save every HD episode of Game of Thrones on Samsung Galaxy A10e?	no </s>
Was the tenth Amendment to the Constitution written using Pitman shorthand?	no </s>
Are the founders of Skype from Asia?	no </s>
Can actress Danica McKellar skip astronaut education requirements?	yes </s>
Did Robert Downey Jr. possess same caliber gun as Resident Evil's Barry Burton?	yes </s>
Can a copy of The Daily Mirror sustain a campfire?	yes </s>
Could a Porsche 992 Turbo S defeat Usain Bolt in a 100 meter sprint?	yes </s>
During the Cuban revolution, did the US experience a population boom?	yes </s>
Can you buy furniture and meatballs in the same store?	yes </s>
Was there fear leading up to the year 2000?	yes </s>
Did Leonardo da Vinci lack contemporary peers in his home city?	no </s>
Is nickel dominant material in US 2020 nickels?	no </s>
Can Africanized bees be considered multicultural?	yes </s>
Were all of Heracles's children present for his funeral pyre?	no </s>
Is Phobos part of the Andromeda galaxy?	no </s>
Can lobster breathe in the desert?	no </s>
Are parodies of the President of the United States illegal?	no </s>
Can oysters be used in guitar manufacturing?	yes </s>
Can the US branch of government that has power over the military also have the power to veto?	yes </s>
Have any murderers outlasted Kane's Royal Rumble record?	yes </s>
Will a 2 Euro coin float across the Red Sea?	no </s>
Could a sloth hypothetically watch an entire episode of Scrubs underwater?	yes </s>
Did Marco Polo travel with Christopher Columbus?	no </s>
Did the Presidency of Bill Clinton conclude with his impeachment?	no </s>
Could someone in the Canary Islands fish for largemouth bass?	no </s>
Is the referee at a soccer match highly visible against the field?	yes </s>
Is dyslexia the most common intellectual disability in US?	no </s>
Did Ada Lovelace die tragically young for her era?	no </s>
Does the Constitution of the Philippines copy text from the British constitution?	no </s>
Is Argon near Neon on the periodic table of elements?	yes </s>
Do oak trees have leaves during winter?	no </s>
Does Ronda Rousey avoid BBQ restaraunts?	yes </s>
Does Amtrak run from NYC directly to the Moai location?	no </s>
Is Supreme Court of the United States analogous to High Courts of Justice of Spain?	no </s>
Would Tony Stark be considered a polymath?	yes </s>
Did Rand Paul frequently swim in Lake Michigan during his undergraduate years?	no </s>
Is SnapCap an example of a retail store?	no </s>
Can furniture be made of hair?	yes </s>
Is March named after Jupiter's son in Roman mythology?	yes </s>
Can the theory of cultural hegemony explain global warming?	no </s>
Is it impossible for pigs to use pig latin?	yes </s>
Is J.D. Salinger's most successful work influential to killers?	yes </s>
Did Ice make people rich?	yes </s>
Does Justin Bieber vote in October?	yes </s>
Do flying fish have good eyesight?	yes </s>
Does Carl Linnaeus share the same final resting place as Michael Jackson?	no </s>
Is xenophobia hypothetically unimportant between Saladin and Ali Askari?	yes </s>
Can a dolphin keep a diary?	no </s>
Is the Jurassic era a tourist destination?	no </s>
Are any of the words that CAPTCHA stands for palindromes?	no </s>
Would a binge watch of entire Young and the Restless take longer than a leap year?	yes </s>
Was the original Metroid groundbreaking for its polygons?	no </s>
Do you need to schedule separate preventive healthcare and sickness visits? 	yes </s>
Is Anakin Skywalker from Star Wars associated with the color black?	yes </s>
Can whole genome sequencing be used for COVID-19?	no </s>
Do people with swallowing disorders need high viscosity drinks?	yes </s>
Were Depeche Mode heavily influenced by blues music?	no </s>
Was being a mail carrier considered one of the most dangerous jobs?	yes </s>
Is Sea World hazardous to leopard seal's health?	yes </s>
Would a compact disc melt in magma?	yes </s>
Does Canada have a relationship with a monarch?	yes </s>
Did Modern Family win a Slammy award?	no </s>
Can a grey seal swim in the same water as the subject of Moby Dick?	yes </s>
Does the name C-SPAN refer to a form of telecommunications that utilizes outer space?	yes </s>
Did Johann Sebastian Bach influence heavy metal?	yes </s>
Can your psychologist say hello to you while you are out at the supermarket?	no </s>
Will Dustin Hoffman likely vote for Trump in 2020?	no </s>
Do people with mood disorders need permanent institutionalization?	no </s>
Can Poland Spring make money in the Sahara?	yes </s>
Was 847 Pope Leo same iteration of his name as Ivan the Terrible?	yes </s>
Could the Powepuff Girls make the background to the Azerbaijani flag?	yes </s>
Is there a Harry Potter character named after Florence?	yes </s>
Would a snakebite hypothetically be a threat to T-1000?	no </s>
Did Malcolm X avoid eating ham?	yes </s>
Would New Year's Eve hypothetically be Bacchus's favorite holiday?	yes </s>
Are black and white prison uniforms made to resemble a zebra?	no </s>
Did Jack Dempsey ever witness Conor McGregor's fights?	no </s>
Is immersion in virtual reality testable on cnidarians before humans?	no </s>
Is the Holy Land important to Eastern religions?	no </s>
Is Home Depot a one stop shop for crucifixion supplies?	yes </s>
Can you carry a Chrysler in a laptop bag?	no </s>
Would a bodybuilder enjoy wearing a cast for several weeks?	no </s>
Would Temujin hypothetically be jealous of Charlemagne's conquests?	no </s>
Can DRL Racer X drone get across Brooklyn Bridge in 18 seconds?	no </s>
Would a human following a hyena diet be unwelcome at a vegan festival?	yes </s>
Is it normal to see a red panda in Shanghai outside of a zoo?	no </s>
Are Mayors safe from harm from the federal government?	no </s>
Would 2019 Natalie Portman avoid a Snickers bar due to her diet?	yes </s>
Can you listen to the entire Itunes song catalog in one year?	no </s>
Could white rice go rancid before sesame seeds?	no </s>
Does the Taco Bell kitchen contain cinnamon?	yes </s>
Are most mall Santa Claus actors white?	yes </s>
Does having lip piercings lead to more expensive dental bills?	yes </s>
Are you more likely to find bipolar disorder in a crowd than diabetes?	no </s>
Do anatomical and symbolic hearts look remarkably different?	yes </s>
Are fossil fuels reducing jobs in the Gulf of Mexico?	yes </s>
Did Medieval English lords engage in fair trade with peasants?	no </s>
Is the name of a mythical creature also the name of a Small Solar System body?	yes </s>
Do astronomers write horoscopes?	no </s>
Could a Diwali celebration feature a crustacean?	yes </s>
Are there any chives hypothetically good for battling vampires?	yes </s>
Can you make an MP3 from the Golden Gate Bridge?	yes </s>
If you were at an Apple store, would most of the computers be running Ubuntu?	no </s>
Did Lamarck and Darwin agree about the origin of species diversity?	no </s>
Was Saint Vincent and the Grenadines named by an Italian explorer?	yes </s>
Was milliner in Alice in Wonderland (1951 film) likely in need of succimer?	yes </s>
If you have black hair and want red hair, do you need bleach?	yes </s>
Can you buy Reddit at Walmart?	no </s>
In order to work in district management, does one need a car?	yes </s>
Are slime lilies in a different scientific family than asparagus?	no </s>
Is the Forbidden City host to a wooden rollercoaster?	no </s>
Did any cultures associate celery with death?	yes </s>
Would toast for a vegan have margarine instead of butter?	yes </s>
Was Michael Crichton ever in danger of flunking out of Harvard as an undergraduate?	no </s>
Would Jolly Green Giant's largest monument look impressive next to Pyrenees?	no </s>
Would Quiet from Metal Gear be a poor hypothetical choice for lecturer at Haub?	yes </s>
Could morphine cure HIV?	no </s>
Could you buy Hershey's Kisses in red foil with farthings after 1960?	no </s>
Is an ammonia fighting cleaner good for pet owners?	yes </s>
Did the founders of the biggest city in Orange County, California speak Italian?	no </s>
Did Isaac's father almost commit similar crime as Marvin Gay Sr.?	yes </s>
Could the Jackson 5 play a full game of rugby with each other?	no </s>
Is Snickers helpful for weight loss?	no </s>
Is the United States the largest exporter of Fair Trade products?	no </s>
Was Harry Potter a better investment than The Matrix for Warner Bros.?	yes </s>
Does Lemon enhance the flavor of milk?	no </s>
Would Tom Cruise ever insult L. Ron Hubbard?	no </s>
Would 2020 Toyota Supra lag behind at a Nascar rally?	yes </s>
Can Reiki be stored in a bottle?	no </s>
Can you see Stonehenge from a window in Dusseldorf?	no </s>
Does Lorem ipsum backwards fail to demonstrate alliteration?	no </s>
Could casualties from deadliest war rival France's population?	no </s>
Do pediatricians perform abortions?	no </s>
If you're reducing salt intake, are olives a healthy snack?	no </s>
Have the Israelis played the Hammerstein Ballroom?	no </s>
Did the Pearl Harbor attack occur during autumn?	yes </s>
Did Al-Farabi ever meet Mohammed?	no </s>
Could William Franklyn-Miller win a 2020 Nascar Cup Series race?	no </s>
Are the knights in the Medieval Times show not authentic knights?	yes </s>
Would costumes with robes and pointy hats be helpful for Macbeth?	yes </s>
Was Lord Voldemort taught by Professor Dumbledore?	yes </s>
Is Christianity better for global warming than Satanism?	yes </s>
Were mollusks an ingredient in the color purple?	yes </s>
Are twinkies considered artisan made products?	no </s>
Was the sable depicted in Marvel comics anthropomorphic?	no </s>
Did mercenaries fight for England in the Glorious Revolution?	no </s>
Is groundhog day used as a global season indicator? 	no </s>
Would a Yeti be likely to have prehensile limbs?	yes </s>
Can an asteroid be linked with virginity?	yes </s>
Did Sugar Ray Robinson win a fight against Canelo Alvarez?	no </s>
In geometry terms, is the Royal Observatory in Greenwich similar to a yield sign?	no </s>
Did Monty Python write the Who's on First sketch?	no </s>
Did Charlemagne have a bar mitzvah?	no </s>
Is entire Common Era minuscule to lifespan of some trees?	yes </s>
Would kaffir lime be good in a White Russian?	no </s>
Could eating Chinook salmon help Ryan Reynolds?	yes </s>
In teenagers and young adults with depression, are SSRI medications less safe than they are for adults?	yes </s>
Are red legs a sign of failing health in those with Anorexia Nervosa?	yes </s>
Do citizens of Cheshire sing La Marseillaise?	no </s>
Are seasons of Survivor surpassed by number of Ancient Greek letters?	no </s>
Would a jumping spider need over half a dozen contact lenses?	yes </s>
Would Harvey Milk have approved of Obama?	yes </s>
Would dual-energy X-ray absorptiometry be useful if performed on a crab?	no </s>
Would a house full of aloe vera hypothetically be ideal for Unsinkable Sam?	no </s>
Can a human eat an entire 12-lb roast turkey in an hour? 	no </s>
Was Kurt Cobain's death indirectly caused by Daniel LeFever?	yes </s>
Was Charles Manson's body unwanted?	no </s>
Are peaches best eaten when firm?	no </s>
Is Jack Black's height enough to satisfy Coronavirus distancing?	no </s>
Can children be soldiers in the US Army?	no </s>
Could Charlie Bucket be a hotel manager?	no </s>
Can paresthesia be caused by a white pigment?	yes </s>
Would Elon Musk be more likely to know about astrology than physics?	no </s>
Is Pearl Harbor the mythical home of a shark goddess?	yes </s>
Would it be impossible to keep an ocean sunfish and a goldfish in the same tank?	yes </s>
Did Demi Lovato's ancestors help turn maize into popcorn?	yes </s>
Was Alexander the Great baptized?	no </s>
Are Scottish people Albidosi?	yes </s>
Would you spend less on your food at Aldi than at Whole Foods?	yes </s>
Was Los Angeles Memorial Sports Arena hypothetically inadequate for hosting Coachella?	yes </s>
Does water have viscosity?	no </s>
Did Julius Caesar read books on Pharmacology?	no </s>
NATO doesn't recognize double triangle flag countries?	yes </s>
Could a dichromat probably easily distinguish chlorine gas from neon gas?	no </s>
Is the saltwater crocodile less endangered than the European otter?	yes </s>
Is the Muslim world hostile to Israel?	yes </s>
Was the Carnation Revolution the deadliest revolution in Europe?	no </s>
Can you conduct surveillance from a teddy bear?	yes </s>
Was a Tiny House ceiling out of Osama bin Laden's reach?	no </s>
Is a northern fur seal needing emergency surgery in July likely a safe anesthesia candidate?	yes </s>
Would it be very difficult for Nuno Gomes to dive to the Red Sea's deepest point?	yes </s>
Is breast cancer associated with a ribbon?	yes </s>
Could common warthog be useful for scrimshaw?	yes </s>
Tata Hexa can accomodate every Spice Girl?	yes </s>
Would lumberjacks get full after eating three dosa?	no </s>
Do gorillas fight with panda bears?	no </s>
Is the Foreign and Commonwealth Office a European political agency?	yes </s>
Are there any official American knights?	no </s>
Are two cans of Campbell's Soup a day good for hypertension?	no </s>
Can Kit & Kaboodle hypothetically help someone past the Underworld gates?	no </s>
Could an American confuse breakfast in British cuisine for dinner?	yes </s>
Is it true that gay male couples cannot naturally reproduce?	no </s>
Is a krabby patty similar to a cheeseburger?	yes </s>
Are both founders of Ben & Jerry's still involved in the company?	no </s>
Was ship that recovered Apollo 13 named after a World War II battle?	yes </s>
Would Ringo Starr avoid the pot roast at a restaurant?	yes </s>
Is starving Hamas agent eating pig bad?	no </s>
Are Citizens of Bern Switzerland are descendants of Genghis Khan?	yes </s>
Is Lord Voldemort associated with a staff member of Durmstrang?	yes </s>
Does Dean Cain have less days to birthday than Will Ferrell every 4th of July?	no </s>
Does Rahul Dravid belong to the family Gryllidae?	no </s>
Will bumblebees derail the United States presidential election?	no </s>
Does Ludacris have Greek heritage?	yes </s>
Can you see the Statue of Freedom from the Statue of Liberty?	no </s>
Has spinach been a source of power in a comic movie?	yes </s>
For Hostas to look their best, do they need lots of chlorophyll?	yes </s>
Did Jeremy Irons master sweep picking as a child?	no </s>
Would the Cookie Monster decline an offer of free Keebler products?	no </s>
Are grapes essential to winemaking?	no </s>
Can the majority of vowels be typed on the first line of a QWERTY keyboard?	yes </s>
Is the Golden eagle considered a scavenger bird?	no </s>
Can an elite runner circle the Pyrenees in one day?	no </s>
Is Hermes equivalent to the Roman god Vulcan?	no </s>
Is it understandable to compare a blood spatter pattern to a Jackson Pollock piece?	yes </s>
Has Johns Hopkins University always treated subjects ethically?	no </s>
In Hey Arnold, did any characters stay on a porch all the time?	yes </s>
Are some Brazilian Navy ships built in Britian?	yes </s>
Are sables related to wolverines?	yes </s>
Is a watchmaker likely to be able to fix an Apple Watch?	no </s>
Was Noah concerned with buoyancy?	yes </s>
Can you buy a fair trade laptop?	no </s>
Is it foolish to stand on giraffe's head to see over Eiffel Tower?	yes </s>
Was a nuclear bomb used in the Napoleonic Wars?	no </s>
Does Nicole Kidman know any Scientologists?	yes </s>
Would Kylee Jenner ask for no cream in her coffee?	yes </s>
Could the leader of Heaven's Gate save images in JPEG format?	yes </s>
Did pirates who had scurvy need more Vitamin C?	yes </s>
Did producer of Easy Rider ever star in a movie with Dean Cain's Princeton girlfriend?	yes </s>
Can depression be mistaken for laziness?	yes </s>
Is the average bulk carrier ideal for transporting bromine at room temperature?	no </s>
Would human race go extinct without chlorophyll?	yes </s>
Walt Disney dominated his amusement park peers at Academy Awards?	yes </s>
Can a human heart last from NYC to Raleigh NC by Toyota Hiux?	yes </s>
Can the history of art be learned by an amoeba?	no </s>
Do Snow White dwarves best The Hobbit dwarves in battle?	no </s>
Would Rime of the Ancient Mariner make a good sonnet?	no </s>
Has type of political association Pompey had with Caesar influenced reality TV?	yes </s>
Is CEO of Nissan an internationally wanted fugitive?	yes </s>
Is Statue of Unity hypothetically more level with Statue of Liberty than Lighthouse of Alexandria?	no </s>
Is surfing popular in Des Moines, Iowa?	no </s>
Paleography hypothetically helps to understand Cthulhu?	yes </s>
Do members of the Supreme Court of the United States have longer terms than most senators?	yes </s>
Were some people afraid of New Years Day coming in 1999?	yes </s>
Are some chiropractic manipulations dangerous?	yes </s>
Can you buy spinal cord at Home Depot?	no </s>
Would eliminating competition in the Japanese bulk carrier market be profitable for a steel company?	yes </s>
Is Issac Newton often associated with a red fruit?	yes </s>
Would it be possible to fit a football field in Alcatraz Island?	yes </s>
Did mongoose come from later period than rhinos?	yes </s>
Would 1943-S penny be good for making silverware?	yes </s>
Does Felix Potvin have a position on a dodgeball team?	no </s>
Could Steven Spielberg send emails as a child?	no </s>
Does a Disney princess on Broadway have red hair?	yes </s>
Can you find Bob Marley's face in most smoke shops?	yes </s>
Can a martyr saint have been excommunicated?	yes </s>
Could Toyota stadium house people suffering homelessness in Michigan?	yes </s>
Would it be impossible to seat every Chief Justice of the United States on a Boeing 737?	no </s>
Is Cookie Monster's diet Paleo friendly?	no </s>
Were all the materials to make a cannon known during the bronze age?	no </s>
Do American teams in National Hockey League outnumber Canadian teams?	yes </s>
Has Elon Musk's hairline changed?	yes </s>
Does Nintendo's link ever see an astronomer?	yes </s>
Does the swastika have positive uses?	yes </s>
Is a doctorate required to teach at a SUNY School?	no </s>
Did University of Pittsburgh founder have great deal in common with Judith Sheindlin?	yes </s>
Is Disney associated with Los Angeles County?	yes </s>
Could a bee hummingbird balance a scale with a single pea on it?	no </s>
Can photography be considered abstract art?	no </s>
Can the Great Depression be treated with Prozac?	no </s>
Is Edward Snowden in hiding from the United States?	no </s>
Are aggressive bumblebees suicidal?	no </s>
Has categories of Nobel prizes remained same since Alfred Nobel established them?	no </s>
Is British Airways the air force of the United Kingdom?	no </s>
Is a slime mold safe from cerebral palsy?	yes </s>
Was Harry Potter and the Philosopher's Stone popular during the great depression?	no </s>
Is the CIA part of the Department of Defense?	no </s>
Would the owners of the company Peter Griffin works for need barley?	yes </s>
Is an Eastern chipmunk likely to die before seeing two leap years?	yes </s>
Does Ahura Mazda have a rivalry with Zeus?	no </s>
Did Holy Land belong to Adamu's tribe?	yes </s>
Was Edward II crucial to England's victory at Battle of Falkirk?	no </s>
Would a model be likely to frequently enjoy the menu at Cookout?	no </s>
Could a markhor give birth three times in a single year?	no </s>
Could a delicious recipe be made with The Onion?	no </s>
Do most college students own a fax machine?	no </s>
Do Leafhoppers compete with Log Cabin syrup producers for resources?	yes </s>
Does the Pixar film Brave feature Scottish people?	yes </s>
Would a vegetarian be able to eat something at Chick-fil-A?	yes </s>
Could  jockey win Triple Crown between Eid al-Fitr endpoints?	no </s>
Did Harry Houdini appear on Chris Angel Mindfreak?	no </s>
Do some psychotherapy patients have no mental illness?	yes </s>
Is purchasing food for a Lolcat unnecessary?	yes </s>
Would a Common warthog starve in a greenhouse?	no </s>
Would alligator best saltwater crocodile in hypothetical Lake Urmia battle?	no </s>
Is Sirius part of a constellation of an animal?	yes </s>
Is Y2K relevant to the plot of The Godfather?	no </s>
Could a two-year old win a Scrabble tournament?	no </s>
Could chives be mistaken for grass?	yes </s>
Does a giant green lady stand in New York Harbor?	yes </s>
Was only woman to serve as U.S. Speaker of the House alive during the attack on Pearl Harbor?	yes </s>
Is honey associated with queens?	yes </s>
Is it dark is Basel during the day in Los Angeles?	yes </s>
Does penicillin cure a learning disability?	no </s>
Would Mickey Mouse blend in with the American flag?	no </s>
Was hippie culture encouraged by the government in the Soviet Union?	no </s>
Can you house a giant squid at Soldier Field?	yes </s>
Can Iowa be hidden in the English Channel?	no </s>
Do Flat Earthers doubt the existence of Earth's magnetic field?	yes </s>
Has CNES planted a French flag on the lunar surface?	no </s>
Was story of Jesus inspired by Egyptian myth?	yes </s>
Can you see live harbor seals in Washington DC?	yes </s>
Is blonde hair green eyed Sara Paxton considered a Latino?	yes </s>
Does the human stomach destroy a bee if ingested?	yes </s>
Could largest ship from Voyages of Christopher Columbus haul Statue of Liberty?	no </s>
Would it be uncommon for a high schooler to use the yellow pages?	yes </s>
Is pi in excess of square root of 5?	yes </s>
Would Iris (mythology) and Hermes hypothetically struggle at a UPS job?	no </s>
Would Doctor Strange like the Pittsburgh Steelers logo?	yes </s>
Can you give at least one word from the Torah to all residents of Bunkie Louisiana?	yes </s>
Does the texture of leaves remain the same independent of their coloring changing?	no </s>
Can all of Snow White's dwarfs play a game of 7 Wonders simultaneously?	yes </s>
Could the Dominican Order hypothetically defeat Blessed Gerard's order?	no </s>
Is Steve Carell's character on The Office portrayed as one with tremendous leadership skills?	no </s>
Could Christopher Nolan's movies finance Cyprus's entire GDP?	no </s>
Did Subway have a sex offender as a spokesperson?	yes </s>
Did Zorro carve his name into items regularly?	no </s>
Is there a Yeti associated with Disney theme parks?	yes </s>
Did either side score a touchdown during the Football War?	no </s>
Is grief always obvious when it is being experienced?	no </s>
Did Jack Dempsey have most title fight wins in either of his weight classes?	no </s>
Was Subway involved in a pedophilia scandal?	yes </s>
Are implants from an ORIF surgery affected by the magnetic field of the Earth?	no </s>
Can a banana get a virus?	yes </s>
Would E.T. the Extra-Terrestrial alien hypothetically love Friendly's?	yes </s>
Could Sugar Ray Robinson box if he stole in Iran?	no </s>
Would a TMNT coloring book have pizza in it?	yes </s>
Does crucifixion violate US eighth amendment?	yes </s>
Should you wrap a gift for a mother of a stillborn in stork wrapping paper?	no </s>
Would the historic Hattori Hanz≈ç admire Naruto?	no </s>
Was Muhammed a member of the Uniting Church in Australia?	no </s>
Do sand cats avoid eating all of the prey of eels?	no </s>
Did Paul the Apostle's cause of death violate the tenets of Ahimsa?	yes </s>
Would a sophist use an √©p√©e?	no </s>
In most Mennonite homes, would children know of The Powerpuff Girls?	no </s>
Is Freya a combination of Athena and Aphrodite?	yes </s>
Could you brew beer from start to finish in the month of September?	no </s>
When en route from China to France, must pilots know their altitude in the imperial foot?	yes </s>
Would Gomer Pyle salute a lieutenant?	yes </s>
Does the Prime Minister of the United Kingdom have poor job security?	yes </s>
Does The Jungle Book contain racist subtext?	yes </s>
If you're pregnant, might you be recommended ginger?	yes </s>
Are the events of Star Trek: The Next Generation in the history of the world?	no </s>
Is pig meat considered inedible within the cuisine of Hawaii?	no </s>
Is hanging a viable execution method on a ship at sea?	yes </s>
Can you hunt Iberian wolves in the Southern United States?	no </s>
Were there greater landslides than 1980 United States presidential election?	yes </s>
Does the word swastika have meaning in sanskrit?	yes </s>
Could the Toyota Stadium sit a tenth of the population of Gotheburg?	no </s>
Do all of the African regions that participated in the Portugese Colonial War share an official language?	yes </s>
Can a Liebherr LTM 11200-9.1 hypothetically lift Mount Emei?	yes </s>
Can the Department of Defense perform a solo?	no </s>
Does a bumblebee have to worry about spider veins?	no </s>
Are queen bees unnecessary for growing apples?	yes </s>
Can you taste Law & Order?	no </s>
Does Osama bin Laden put a wafer on his tongue every Sunday?	no </s>
Will the producer of Easy Rider become an octogenarian in 2021?	no </s>
Was the Treaty of Versailles settled over blueberry scones?	no </s>
Is it best to avoid kola nuts with colitis?	yes </s>
Would Donald Duck be allowed into most grocery stores?	no </s>
Does the United States of America touch the Indian Ocean?	no </s>
Can second row of QWERTY keyboard spell Abdastartus's kingdom?	yes </s>
Are all types of pottery safe to cook in?	no </s>
Should you ask a neighbor for candy on New Year's Eve?	no </s>
Would Eye surgery on a fly be in vain?	yes </s>
Can Jabberwocky be considered a sonnet?	no </s>
Is white light the absence of color?	no </s>
Could Christopher Walken enlist in the United States Marine Corps?	no </s>
Is number of stars in Milky Way at least ten times earth's population?	yes </s>
Can The Hobbit be read in its entirety in four minutes?	yes </s>
Will you see peach blossoms and Andromeda at the same time?	no </s>
Could Arnold Schwarzenegger hypothetically defeat Haf√æ√≥r Bj√∂rnsson in a powerlifting competition if both are at their peak strength?	no </s>
Was Mesopotamia part of what is now China?	no </s>
In Doctor Who, did the war doctor get more screen time than his successor?	no </s>
Are some types of pancakes named after coins?	yes </s>
Would J.K Rowling's top sellers be on a fantasy shelf?	yes </s>
Was P. G. Wodehouse's favorite book The Hunger Games?	no </s>
Will The Exorcist stimulate limbic system?	yes </s>
Do silicone suits make judo difficult?	yes </s>
Could you watch all of JAG in six months?	yes </s>
In isopropyl alcohol, is the solubility of salt low?	yes </s>
Was the Japanese street aesthetic once illuminated by noble gasses?	yes </s>
Could Rich and Morty be triggered for children of alcoholics?	yes </s>
Does it seem like the Gorillaz is composed of more members than they have?	yes </s>
Does a person suffering from Thalassophobia enjoy oceanography?	no </s>
Is Glycol something United Airlines would buy?	yes </s>
Is Poseidon similar to the god Vulcan?	no </s>
Can members of the Green Party of England and Wales vote in the USA?	no </s>
Do depressed people travel to the Golden Gate Bridge often?	yes </s>
Do some people soak in olive oil and water?	yes </s>
Are Durian fruits an olfactory delight?	no </s>
Can Aerosmith legally drive in the carpool lane?	yes </s>
Can petroleum jelly be used as fuel in a car?	no </s>
Do spider wasps have eight legs?	no </s>
Is Newt Gingrich's nickname a type of Reptile?	no </s>
Do you need both hot and cold water to peel a tomato?	yes </s>
Does 2015 have more unlucky Friday's than usual?	yes </s>
Did Jesus know anyone who spoke Estonian?	no </s>
Would The Dark Knight be appropriate for a preschool class?	no </s>
Are all limbs required for jujutsu?	no </s>
Can you get a ride on Amtrak to the Underworld?	no </s>
Did Jackson 5 members exceed number in The Osmonds?	no </s>
Did Mickey Mouse appear in a cartoon with Bugs Bunny in 1930?	no </s>
Is Isaac Newton buried at the same church as the author of Great Expectations?	yes </s>
Do most middle class families have butlers?	no </s>
Is letter C crucial to spelling the two most common words in English language?	no </s>
Is a felony jury enough people for a Bunco game?	yes </s>
In baseball, is a "Homer" named after the poet Homer who wrote the Odyssey?	no </s>
Does Kenny G hold the qualifications to be a tax collector?	yes </s>
Do guitarists need both hands to play?	yes </s>
Karachi was a part of Alexander the Great's success?	yes </s>
Would a bodybuilder choose maize over chicken breast for dinner?	no </s>
Was King Kong (2005 film) the lead actress's biggest box office role?	yes </s>
Are some Do It Yourself projects potentially lethal?	yes </s>
Has mummification in the Andes been prevented by rainfall?	no </s>
Can lettuce result in spontaneous abortion?	yes </s>
Is number of different US President's in 1800s a lucky number in Hong Kong?	no </s>
Do any video games about the end of civilization have slot machines?	yes </s>
Would Terence Tao outperform Eminem in a math competition?	yes </s>
Does a person using tonsure have hair at the top of their scalp?	no </s>
Does someone from Japan need a passport to go to a Nordic country?	yes </s>
Would you find a tibia beside parsley on a holiday plate?	yes </s>
Did Hanuman ever experience an orgasm?	no </s>
Could someone listen to the entire U2 debut studio album during an episode of Peppa Pig?	no </s>
Would Brian Warner be a good singer for a soul music band?	no </s>
Would three commas be sufficient for displaying US 2018 GDP?	no </s>
Can a person who knows only English read Kanji?	no </s>
Was Walt Disney able to email his illustrations to people living far away?	no </s>
Could Katharine Hepburn have ridden the AirTrain JFK?	no </s>
Was Great Recession the period of severest unemployment?	no </s>
At Christmastime, do some films remind us that groundhog day is approaching?	yes </s>
Would Michael Phelps be good at pearl hunting?	yes </s>
Do hornets provide meaningful data for oceanographers?	no </s>
Is 500GB USB device enough to save 10 hours of Netflix shows a day?	no </s>
Can COVID-19 spread to maritime pilots?	yes </s>
Could B be mistaken for an Arabic numeral?	yes </s>
Did occupants of Vellore Fort need to defend themselves from Grizzly Bears?	no </s>
Did a gladiator kill his opponent with a shotgun?	no </s>
Would Immanuel Kant be disgusted by the Black Lives Matter movement?	yes </s>
Will 2020 elephant pregnancy last past next year with 4 solar eclipses?	no </s>
Is an espresso likely to assuage fear?	no </s>
Do you often hear Marco Polo's name shouted near water?	yes </s>
Did Donatello use a smartphone?	no </s>
Was the death of Heath Ledger caused by his work on The Dark Knight?	no </s>
Is "A Tale of Two Cities" a parody of the Bible?	no </s>
Is the letter D influenced by the shape of ancient doors?	yes </s>
Did Julio Gonzalez like acetylene?	yes </s>
Is clerk of Supreme Court of Canada safe profession for someone with seismophobia?	yes </s>
Does Antarctica have a lot of problems relating to homelessness?	no </s>
Are coopers required in the beverage industry?	yes </s>
Gandalf hypothetically defeats Rincewind in a wizard battle?	yes </s>
Would an Alfa Romeo vehicle fit inside a barn?	yes </s>
Is strep throat harmless to singer Rita Ora after her 2020 tonsilitis surgery?	no </s>
Would the United States Military Academy reject an applicant with multiple sclerosis?	yes </s>
Could someone in Tokyo take a taxi to the The Metropolitan Museum of Art?	no </s>
Does Adobe Suite have video game engine coding?	yes </s>
Is Europa (moon) name origin related to Amunet?	no </s>
Was Jean Valjean imprisoned due to hunger?	yes </s>
Would someone on Venus be unlikely to experience hypothermia?	yes </s>
Is Jack Black unlikely to compete with Bear McCreary for an award?	yes </s>
Would Cuba Libre consumption help with insomnia?	no </s>
Does Nigella Lawson care about solubility?	yes </s>
Can E6000 cure before a hoverboard finishes the Daytona 500? 	yes </s>
Could the Pope be on an episode of Pimp My Ride?	yes </s>
Are pennies commonly used in Canada?	no </s>
Do drag kings take testosterone to look masculine?	no </s>
Will Chick Fil A be open on Halloween 2021?	no </s>
Can you order an Alfa Romeo at Starbucks?	no </s>
Would a recruit for the United States Marine Corps be turned away for self harm?	yes </s>
Would it be unusual to see frost in September in Texas?	yes </s>
Did breakdancing grow in popularity during WW2?	no </s>
Can vitamin C rich fruits be bad for health?	yes </s>
Could a monarch butterfly rule a kingdom?	no </s>
If it socially acceptable to wear an icon depicting crucifixion? 	yes </s>
Can people die from brake failure?	yes </s>
Was the man who played the male lead in Mrs. Doubtfire known for his humour?	yes </s>
Coud every wife of Stone Cold Steve Austin fit in Audi TT?	yes </s>
Is Hamlet more common on IMDB than Comedy of Errors?	yes </s>
Has Freemasonry been represented on the Moon?	yes </s>
Do urban legends always have to occur in cities?	no </s>
Would a fungal life-form be threatened by a pigment from copper?	yes </s>
Do the telescopes at Goldstone Deep Space Communications Complex work the night shift?	yes </s>
Was Jackson Pollock straight edge?	no </s>
Is it legal for a licensed child driving Mercedes-Benz to be employed in US?	yes </s>
Would a sofer be a bad job for a vegan?	yes </s>
Can an African Elephant get pregnant twice in a year?	no </s>
Did Joan Crawford guest star on  JAG (TV series)?	no </s>
Will Elijah Cummings vote for Joe Biden in the next presidential elections?	no </s>
Do people watching Coen brothers films in Guinea Bissau need subtitles?	yes </s>
Is Great Pyramid of Giza the last wonder of its kind?	yes </s>
Hydrogen's atomic number squared exceeds number of Spice Girls?	no </s>
If you have a serious injury in Bangladesh, would you probably dial a Fibonacci number?	no </s>
Are Donkeys part of Christmas celebrations?	yes </s>
Did polio medicine save the life of polio vaccine creator?	no </s>
Is latitude required to determine the coordinates of an area?	yes </s>
Can Harry Potter book a flight on Asiana Airlines?	no </s>
Would a monkey outlive a human being on average?	no </s>
Would Carmine's kitchen staff be panicked if they had no olive oil?	yes </s>
Can a snow leopard eat twice its own body weight?	yes </s>
Are there five different single-digit Fibonacci numbers?	yes </s>
Can Spartina Patens thrive in the Sahara Desert?	no </s>
Is growing seedless cucumber good for a gardener with entomophobia?	yes </s>
Would it be unusual to use paypal for drug deals?	yes </s>
Is Casio's founding year a composite number?	yes </s>
Would ISIS agree with Al-Farabi's religious sect?	no </s>
Would half muggle wizards fear Lord Voldemort?	yes </s>
Is a construction worker required to build a portfolio?	no </s>
Are vinegar pickled cucumbers rich in lactobacillus?	no </s>
Would a dog easily notice ammonia?	yes </s>
Are the brooms from curling good for using on house floors?	no </s>
Is Christopher Walken close to achieving EGOT status?	no </s>
Can sunlight travel to the deepest part of the Black Sea?	no </s>
Did U.S. soldiers listen to Justin Bieber's Believe album during the Battle of Baghdad?	no </s>
Can a honey bee sting a human more than once?	no </s>
Would an expensive tailor use adhesive to create a shorter hem on slacks?	no </s>
Did Clark Gable marry more women once than Richard Burton?	yes </s>
Did the 40th president of the United States forward lolcats to his friends?	no </s>
Did William Shaespeare read the Daily Mirror?	no </s>
Does Disney own a major comic book publisher?	yes </s>
Can jackfruit be used as a weapon?	yes </s>
Do the James Bond and Doctor Who series have a similarity in format?	yes </s>
Does Sam Harris worship Shiva?	no </s>
Would Lord Voldemort hypothetically be an effective fighter after Final Fantasy silence is cast?	no </s>
Does Capricorn astrology symbol have all of the parts of a chimera?	no </s>
Is Black Lives Matter connected with capsaicin?	yes </s>
Do people in middle school usually get breast exams?	no </s>
Is it difficult to conduct astrophotography in the summer in Sweden?	yes </s>
Did Tokyo Tower designers appreciate Stephen Sauvestre?	yes </s>
Would a hippie hypothetically be bummed out by Augustus's Pax Romana?	no </s>
Can oysters be preserved without refrigeration? 	yes </s>
Could the Atlantic readers fill 500 battalions?	no </s>
Is it normally unnecessary to wear a coat in Hollywood in July?	yes </s>
Can the Toyota Hilux tip the scales against Mr. Ed?	yes </s>
Could a young Wizard of Oz Scarecrow have gotten Cerebral palsy?	no </s>
Would Glen Beck and Stephen Colbert be likely to tour together?	no </s>
Could Maroon 5 have hypothetically held a concert at Roman Colosseum?	yes </s>
Does Carmen Electra own a junk?	no </s>
Is 2018 Ashland, Oregon population inadequate to be a hypothetical military division?	no </s>
Do Youtube viewers get unsolicited audiobook advice often?	yes </s>
Did Osama bin Laden likely abstain from alcohol?	yes </s>
Are fresh garlic cloves as easy to eat as roasted garlic cloves?	no </s>
Would JPEG be a good format for saving an image of Da Vinci's Vitruvian Man?	no </s>
Did Lionel Richie ever have dinner with Abraham Lincoln?	no </s>
Is it safe to eat hair?	yes </s>
Did Sojourner Truth use the elevator at the Washington Monument?	no </s>
Was Florence a Theocracy during Italian Renaissance?	yes </s>
Were Beauty and the Beast adaptations devoid of Kurt Sutter collaborators?	no </s>
Would a Nike shoebox be too small to fit a swan in?	yes </s>
Did Johann Sebastian Bach ever win a Grammy Award?	no </s>
Are chinchillas cold-blooded?	no </s>
Is Samsung accountable to shareholders?	yes </s>
Is Alan Alda old enough to have fought in the Vietnam War?	yes </s>
Did Disney's second film rip off a prophet story?	yes </s>
Is eating a Dicopomorpha echmepterygis size Uranium pellet fatal?	no </s>
Can musicians become knights?	yes </s>
Can a lemon aggravate dyspepsia?	yes </s>
Was Oscar Wilde's treatment under the law be considered fair in the US now?	no </s>
Would Jackie Chan have trouble communicating with a deaf person?	no </s>
Could a fan of the Botany Swarm vote for John Key?	yes </s>
Will Conan the Barbarian hypothetically last a short time inside of Call of Duty?	yes </s>
Do pirates care about vitamin C?	yes </s>
Is video surveillance of a room possible without an obvious camera or new item?	yes </s>
Did England win any Olympic gold medals in 1800?	no </s>
In the world of Harry Potter, would a snake and skull tattoo be good luck?	no </s>
Would a Fakir be surprised if they saw a comma in their religious book?	yes </s>
Was Elmo an original muppet character on Sesame Street?	no </s>
Is sunscreen unhelpful for the condition that killed Bob Marley?	yes </s>
Was John Gall from same city as Stanford University?	yes </s>
Snowboarding is a rarity in Hilo?	yes </s>
Did King of Portuguese people in 1515 have familial ties to the Tudors?	yes </s>
Could Darth Vader hypothetically catch the Coronavirus?	no </s>
Is it normal to blow out candles during a funeral?	no </s>
Would a slingshot be improperly classified as artillery?	yes </s>
Did Gladiator's weapon of choice require less hands than Soul Calibur's Faust?	yes </s>
Did Saddam Hussein witness the inauguration of Donald Trump?	no </s>
Is Batman (1989 film) likely to be shown on flight from NY to Kansas City?	yes </s>
Could Eric Clapton's children play a regulation game of basketball among themselves?	no </s>
Can the Supreme Court of Canada fight a Lucha trios match?	yes </s>
Do you need different colored pens for sudoku?	no </s>
Would an ancient visitor to Persia probably consume crocus threads?	yes </s>
Would the Who concert in international space station be audible?	yes </s>
Was King Kong (2005 film) solvent?	yes </s>
During the time immediately after 9/11, was don't ask don't tell still in place?	yes </s>
Would the 10th doctor enjoy a dish of stuffed pears?	no </s>
Will speed reader devour The Great Gatsby before the Raven?	no </s>
Can Michael Jordan become a professional cook in America? 	yes </s>
Can a microwave melt a Toyota Prius battery?	no </s>
Did Irish mythology inspire Washington Irving?	yes </s>
At midnight in Times Square on New Years Eve, are you likely to meet people in diapers?	yes </s>
Would a member of the United States Air Force get a discount at Dunkin Donuts?	yes </s>
Can you put bitcoin in your pocket?	yes </s>
Does Masaharu Morimoto rely on glutamic acid?	yes </s>
Would a nickel fit inside a koala pouch?	yes </s>
When the shuttle Columbia 11 landed, was it the season for Christmas carols?	yes </s>
Did Kurt Cobain's music genre survive after his death?	yes </s>
Are people banned from entering the Forbidden City?	no </s>
Were there eight humans on Noah's Ark?	yes </s>
Was Nikola Tesla's home country involved in the American Civil War?	no </s>
Did Queen Elizabeth The Queen Mother and her daughter share name with Tudor queen?	yes </s>
Did John Lennon listen to Compact discs?	no </s>
Has a tumulus been discovered on Mars?	no </s>
Could Cosmic Girls play League of Legends alone?	yes </s>
is the brain located in the torso?	no </s>
Was Augustus his real name?	no </s>
Were the Spice Girls inspired by Little Mix?	no </s>
Does the actress who played Elizabeth II speak fluent Arabic?	no </s>
Does Super Mario require electricity to play?	yes </s>
Is it impossible to tell if someone is having a stroke?	no </s>
If he were poor, would Christopher Reeve have lived?	no </s>
Could all of the 2008 Summer Olympics women find a hookup athlete partner?	yes </s>
Are any mollusks on Chinese New Year calendar?	no </s>
Can an adult human skull hypothetically pass through the birth canal?	yes </s>
Will Elijah Cummings cast a vote in the 2020 presidential election?	no </s>
Does Super Mario mainly focus on a man in green?	no </s>
Does Julia Roberts lose the prolific acting contest in her family?	yes </s>
Can olive oil kill rabies?	no </s>
Does Ludacris perform classical music?	no </s>
Did U2 play a concert at the Polo Grounds?	no </s>
Did Gauss have a normal brain structure?	no </s>
Could an infant solve a sudoku puzzle?	no </s>
Is Eid al-Fitr holiday inappropriate to watch entire US Office?	yes </s>
Are any of the destinations of Japan Airlines former Axis Powers?	yes </s>
Would a viewer of Monday Night Football be able to catch WWE Raw during commercial breaks?	yes </s>
Would Jon Brower Minnoch break a chair before Voyager 2 launch mass?	no </s>
Do placozoa get learning disabilities?	no </s>
Are multiple Christmas Carol's named after Saints?	yes </s>
Are thetan levels found in the New Testament?	no </s>
Would a honey badger's dentures be different from a wolverine's?	yes </s>
Does the United States Secretary of State answer the phones for the White House?	no </s>
Did the color green help Theodor Geisel become famous?	yes </s>
Does Ariana Grande's signature style combine comfort items and high fashion?	yes </s>
Did Richard III's father have greater longevity than him?	yes </s>
Does a dentist treat Bluetooth problems?	no </s>
Was Walt Disney ever interviewed by Anderson Cooper?	no </s>
Is it common to see frost during some college commencements?	yes </s>
Could Eddie Murphy's children hypothetically fill a basketball court by themselves?	yes </s>
Can you find a snow leopard in the Yucatan?	no </s>
Could Edward Snowden have visited the headquarters of United Nations Conference on Trade and Development?	yes </s>
Did Sony definitively win the video game war against Sega?	yes </s>
Is winter associated with hot temperatures?	no </s>
Does the United States Navy create radioactive waste?	yes </s>
Was Black fly upstaged by another insect in Jeff Goldblum's 1986 film?	yes </s>
Did Alan Rickman have an improperly functioning organ?	yes </s>
Would four shoes be insufficient for a set of octuplets?	yes </s>
Are banana trees used by judges for maintaining order?	no </s>
Could Rhode Island sink into the Bohai Sea?	yes </s>
Will a sloth explode if it's not upside down?	no </s>
Was the MLB World Series held in Newcastle, New South Wales?	no </s>
Would Nancy Pelosi have hypothetically been on same side as Gerald Ford?	no </s>
Was the 1980 presidential election won by a member of the Grand Old Party?	yes </s>
Is Glenn Beck known for his mild temper?	no </s>
Would a kaffir lime be a good ingredient for making a candle?	yes </s>
Did Moon Jae-in's residence exist when the World Trade Center was completed?	no </s>
Is it impossible for Cheb Mami to win a Pulitzer Prize for musical composition?	yes </s>
Did DARPA influence Albert Einstein? 	no </s>
Does the art from Family Guy look a lot like the art in American Dad?	yes </s>
Could Stephen King join the NASA Astronaut Corps?	no </s>
Would Alexander Graham Bell hypothetically support Nazi eugenics?	yes </s>
Can black swan's formation type help spell longest word in Dictionary?	yes </s>
Do you find glutamic acid in a severed finger?	yes </s>
Do German Shepherds worry about the Abitur?	no </s>
Did Tom Bosley enjoy video games on the PlayStation 4?	no </s>
Can a 2019 Toyota Hilux hypothetically support weight of thirty Big John Studd clones?	no </s>
Are potatoes native to the European continent?	no </s>
Would ≈ûerafeddin Sabuncuoƒülu have eaten B√∂rek?	yes </s>
Can the original name of the zucchini be typed on the top row of a QWERTY keyboard?	no </s>
Would Cyndi Lauper use milk substitute in her rice pudding?	yes </s>
Is eggplant deadly to most atopic individuals? 	no </s>
Could a single bitcoin ever cover cost of a Volkswagen Jetta?	yes </s>
Has Drew Carey outshined Doug Davidson's tenure?	yes </s>
Can you purchase a dish with injera at Taco Bell?	no </s>
Would a Superbowl Football Game be crowded on the Gettysburg Battlefield?	no </s>
Would the tunnels at CERN fit onto the High Speed 1 rails?	yes </s>
Would 1996 leap year baby technically be 1 year old in 2000?	yes </s>
Would Snowdon mountain be a piece of cake for Tenzing Norgay?	yes </s>
Can a Reconstruction era coin buy DJI Mavic Pro Drone?	yes </s>
Can an American black bear swallow a sun bear whole?	no </s>
Does monster name in West African Folklore that witches send into villages set Scrabble record?	no </s>
Does Home Depot sell item in late September zodiac sign symbol?	yes </s>
Did the Watergate scandal help the Republican party?	no </s>
Can a sesame seed grow in the human body?	no </s>
Did Elizabeth II frequently visit Queen Victoria?	no </s>
Can you watch Rick and Morty in Mariana Trench?	yes </s>
Does Oprah Winfrey have a degree from an Ivy League university?	yes </s>
Can Darth Vader hypothetically outdunk Bill Walton without using The Force?	no </s>
Did the lead singer of Led Zepplin ever perform with Ernest Chataway?	yes </s>
Would someone with a nosebleed benefit from Coca?	yes </s>
Will Communion be denied to Wednesday name origin followers?	yes </s>
Were Walkman's used in the Kingdom of Hungary?	no </s>
Would a veteran of the Phillippine-American War come home craving SPAM?	no </s>
Could Moulin Rouge have been hypothetically used as Spain's Spanish American War triage center?	yes </s>
Did Metallica band members cutting their hair hurt their sales?	yes </s>
Does the letter B's place in alphabet exceed number of 2008 total lunar eclipses?	yes </s>
Would Emmanuel Macron celebrate Cinco de Mayo?	no </s>
Would a baby gray whale fit in a tractor-trailer?	yes </s>
Was Harry Truman's presidency unaffected by the twenty-third Amendment to the US Constitution?	yes </s>
Could Bart Simpson have owned comics with The Joker?	yes </s>
Do Do It Yourself channels online always show realistic projects?	no </s>
Would only warm weather attire be a good idea on Mercury?	no </s>
Can you measure a Caracal with a protractor?	no </s>
Can a goat be used for one of the ingredients in French toast?	yes </s>
Did Dr. Seuss make himself famous?	no </s>
Was song of Roland protagonist friendly with group that had sagas?	no </s>
Could the endowment of Johns Hopkins University pay off the MBTA debt?	no </s>
Is Christmas celebrated during winter?	yes </s>
Do sun bears stay active during winter?	yes </s>
Could a student at the University of Houston see a caracal on campus?	no </s>
Would someone pay for a coffee in NYC with Euros?	no </s>
Can a single honey bee sting multiple humans?	no </s>
Would the number 666 appear in a church?	no </s>
Is Cape Town south of the Equator?	yes </s>
Will silicon wedding rings outsell bromine wedding rings?	yes </s>
Does ontology require a scalpel?	no </s>
Is Godzilla's image likely grounds for a lawsuit in 2050?	no </s>
Is Olivia Newton-John hyphenated celebrity name with most letters?	no </s>
Will electric car struggle to finish Daytona 500?	yes </s>
Are swastikas used in the most common religion in India?	yes </s>
Is it more expensive to run for President of India than to buy a new iPhone 11?	no </s>
Is it hard for Rahul Dravid to order food at a restaurant in Aurangabad?	no </s>
Did Terry Pratchett write about quantum mechanics?	yes </s>
Did number of Imams Reza Shah believed in exceed number of Jesus's disciples?	no </s>
Does Final Fantasy VI require electricity to play?	yes </s>
Would Dale Earnhardt Jr. be considered a newbie?	no </s>
Is cycling a high-risk activity for pelvis fractures?	no </s>
Would a person with Anorexia nervosa be more likely to break a bone than a regular person?	yes </s>
Is Jennifer Lawrence's middle name similar to the name of a Scorsese collaborator?	yes </s>
Can a ten-pin bowling pin be a deadly weapon?	yes </s>
Can parachuting amateurs ignore hurricane force winds bulletins?	no </s>
Was Moliere Queen Margot's ill fated lover?	no </s>
Would you be more likely to die of hypothermia in New York than Florida?	yes </s>
Did the Democratic Party's nominee for President of the U.S. in 1908 watch TV?	no </s>
Does the cuisine of Hawaii embrace foods considered gross in the continental US?	yes </s>
Did John Kerry run in the 2010 United Kingdom general election?	no </s>
Was The Canterbury Tales written before One Thousand and One Nights?	no </s>
Does  Lionel Richie believe in holistic medicine?	yes </s>
Did villain that killed Superman murder Robin?	no </s>
Is an ocelot a good present for a kindergartener?	no </s>
Were the first missionaries required to attend mass on Sundays?	yes </s>
Will Donald Duck hypothetically purchase bell-bottoms for himself?	no </s>
Was Christina Aguilera born in the forgotten borough?	yes </s>
Would ramen be bad for someone with heart failure?	yes </s>
Would the current president of Ohio University hypothetically wear a jockstrap?	yes </s>
Would an Olympic athlete be tired out after running a mile?	no </s>
Can an ostrich fit into the nest of a swallow?	no </s>
Did Dale Jr hug his dad after their last Daytona 500 together?	no </s>
Did Wednesday have something to do with Thor?	yes </s>
Will AC/DC album sales buy more B-52 bombers than Lil Wayne's?	yes </s>
Do mountain goats inhabit the summit of Mount Sharp?	no </s>
Could Larry King's marriages be counted on two feet?	yes </s>
Were gladiators associated with the Coloseum?	yes </s>
Does Rupert Murdoch's alma mater have more history than the USA?	yes </s>
Do the Ubuntu people speak Ubuntu?	no </s>
Can native wolverines be found in Miami?	no </s>
Were paparazzi involved in the death of a member of the royal family?	yes </s>
Was Moon Jae-in born outside of Khanbaliq?	yes </s>
Can a greyhound walk on two legs?	no </s>
Do moths that live on sloths have family dinners?	no </s>
Do Jehovah's Witnesses celebrate day before New Year's Day?	no </s>
Would a caracal be defeated by Javier Sotomayor in a high jump competition?	no </s>
Were karaoke and the turtle power tiller patented in the same country?	yes </s>
Is Kim Kardashian a guru?	no </s>
Do solo pianists require a conductor?	no </s>
Would Shaggy and Redenbacher popcorn founder both raise hand during first name roll call?	yes </s>
Has a baby ever had a moustache?	yes </s>
Did the original lead guitarist of Metallica fail after parting from the band?	no </s>
Would John Muir not likely have a vitamin D deficiency?	yes </s>
Did Thomas Greenhill's parents violate the concept of monogamy?	no </s>
Is the bull shark more bull than shark?	no </s>
Will a Holstein cow and the Liberty Bell balance out a giant scale?	no </s>
Can citrus grow in Ulaanbaatar?	no </s>
Can a snow leopard swim?	yes </s>
Are LinkedIn and LeafedIn related companies?	no </s>
Is waltz less injurious than slam dance?	yes </s>
Is one blast from double-barreled shotgun likely to kill all squid brains?	no </s>
Is viscosity unimportant in making jello shots?	no </s>
Is Earth Day celebrated in summer?	no </s>
Are you likely to hear Rammstein playing in smooth jazz clubs?	no </s>
Did Moon Jae-in earn the Abitur as a teenager?	no </s>
Can French Toast hypothetically kill a Lannister?	yes </s>
Can a believer in agnosticism become pope?	no </s>
Will Ronda Rousey hypothetically defeat X-Men's Colossus in a fight?	no </s>
Can brewing occur in a prison environment?	yes </s>
Do American wheelchair users know what the ADA is?	yes </s>
Does Lupita Nyongo have citizenship in paternal Family of Barack Obama's origin country?	yes </s>
Is most coffee produced South of the Equator?	yes </s>
Is the largest city in New Mexico also known as Yoot√≥?	no </s>
Is the tongue part of a creature's head?	yes </s>
Does Coast to Coast AM have more longevity than the Rush Limbaugh show?	yes </s>
Is the E.T. the Extra-Terrestrial Atari Landfill story an urban legend?	yes </s>
Can you chew argon?	no </s>
Would a Jehovah's witness approve of Alice's Adventures in Wonderland?	no </s>
Does Santa Claus hypothetically give Joffrey Baratheon presents?	no </s>
Does a lapidary work with items that are studied by geologists?	yes </s>
Was The Great Gatsby inspired by the novel 1984?	no </s>
Is the tibia required for floor exercises?	yes </s>
Is Europa linked to Viennese waltzes?	yes </s>
Is a platypus immune from cholera?	yes </s>
Did Jerry Seinfeld have reason to cheer in 1986?	yes </s>
Would John the Baptist be invited to a hypothetical cephalophore reunion in heaven?	no </s>
Are common carp sensitive to their environments?	no </s>
Have Douglas fir been used to fight wars?	yes </s>
Can you watch the Borgia's World of Wonders before Ludacris's Release Therapy finishes?	yes </s>
Is winter solstice in Northern Hemisphere closer to July than in Southern Hemisphere? 	no </s>
Can a traffic collision make someone a millionaire?	yes </s>
Are Christmas trees typically deciduous?	no </s>
Can you drown in a Swan Lake performance?	no </s>
Is it unusual to eat spaghetti without a fork?	yes </s>
Is narcissism's origin a rare place to get modern words from?	no </s>
Is Kobe's famous animal product used in a BLT?	no </s>
Do Chinese Americans face discrimination at a Federal level in the US?	yes </s>
Could largest asteroid crush a whole city?	yes </s>
Did Mike Tyson do something very different than McGruff's slogan to Evander Holyfield in 1997?	no </s>
After viewing the Mona Lisa, could you get lunch nearby on foot?	yes </s>
Do all parts of the aloe vera plant taste good?	no </s>
Is a fever cured by listening to a cowbell?	no </s>
Are brown rock fish found in the waters surrounding Saint Kitts and Nevis?	no </s>
Do Republicans reject all forms of welfare?	no </s>
Did the confederate states speak Old English before the Civil War?	no </s>
Do Armenians tend to dislike System of a Down?	no </s>
Is a paleo dieter unlikely to color beverages green for St. Patrick's Day?	yes </s>
Can French Defence initial move defend against four move checkmate?	no </s>
Was Emperor Commodus paid tribute in Pound sterling?	no </s>
Do you need a large room if you want to get into 3D printing?	no </s>
Does Woody Allen await the Second Coming?	no </s>
Do you have to pass through circle of lust to find Saladin in Dante's Inferno?	no </s>
Could Intel products be purchased at McDonald's?	no </s>
Is the Yellow Pages the fastest way to find a phone number?	no </s>
Do Shinto practitioners keep to a kosher diet?	no </s>
Are there some countries where waiting staff need no tip?	yes </s>
Could a hamster experience two leap years?	no </s>
Is there a Marvel villain with the same name as a kind of citrus fruit?	yes </s>
Are selfies more dangerous than plague in modern times?	yes </s>
Is a cory catfish likely to eat another living fish?	no </s>
Does Thiago Moises May 13 2020 submission move hypothetically hurt Achilles?	yes </s>
Does Alec Baldwin have more children than Clint Eastwood?	no </s>
Does highest US Court have enough seats for every Prime Minister of the United Kingdom since 1952?	no </s>
